Season,Team,Points,Place,GS,GA,GD,Wins,Losses,Ties
1928,FC Barcelona,36,1,37,23,14,11,4,3
1928,Real Madrid,34,2,40,27,13,11,6,1
1928,Real Sociedad,28,3,46,41,5,8,6,4
1928,Athletic Bilbao,28,4,43,33,10,8,6,4
1928,Arenas de Getxo,27,5,32,39,-7,8,7,3
1928,Atletico Madrid,26,6,43,41,2,8,8,2
1928,Espanyol Barcelona,25,7,32,38,-6,7,7,4
1928,CE Europa,22,8,45,49,-4,6,8,4
1928,Real Union,17,9,40,42,-2,5,11,2
1928,Racing Santander,12,10,25,50,-25,3,12,3
1929,Athletic Bilbao,42,1,63,28,35,12,0,6
1929,FC Barcelona,34,2,46,36,10,11,6,1
1929,Arenas de Getxo,29,3,51,40,11,9,7,2
1929,Espanyol Barcelona,29,4,40,33,7,9,7,2
1929,Real Madrid,24,5,45,42,3,7,8,3
1929,Real Union,23,6,48,52,-4,6,7,5
1929,Racing Santander,21,7,32,58,-26,7,11,0
1929,CE Europa,19,8,29,44,-15,6,11,1
1929,Real Sociedad,19,9,34,37,-3,5,9,4
1929,Atletico Madrid,17,10,32,50,-18,5,11,2
1930,Athletic Bilbao,33,1,73,33,40,11,7,0
1930,Racing Santander,32,2,49,37,12,10,6,2
1930,Real Sociedad,32,3,42,39,3,10,6,2
1930,FC Barcelona,28,4,40,43,-3,7,4,7
1930,Arenas de Getxo,26,5,35,38,-3,8,8,2
1930,Real Madrid,25,6,24,27,-3,7,7,4
1930,Real Union,22,7,41,45,-4,6,8,4
1930,Espanyol Barcelona,20,8,32,45,-13,6,10,2
1930,CD Alaves,19,9,25,39,-14,5,9,4
1930,CE Europa,19,10,23,38,-15,6,11,1
1931,Real Madrid,38,1,37,15,22,10,0,8
1931,Athletic Bilbao,36,2,47,23,24,11,4,3
1931,FC Barcelona,34,3,40,26,14,10,4,4
1931,Racing Santander,27,4,36,35,1,7,5,6
1931,Arenas de Getxo,24,5,35,42,-7,7,8,3
1931,Espanyol Barcelona,22,6,34,39,-5,7,10,1
1931,Valencia CF,21,7,38,47,-9,6,9,3
1931,Real Sociedad,21,8,38,35,3,7,11,0
1931,CD Alaves,16,9,22,44,-22,5,12,1
1931,Real Union,15,10,24,45,-21,4,11,3
1932,Real Madrid,41,1,49,17,32,13,3,2
1932,Athletic Bilbao,39,2,63,30,33,13,5,0
1932,Espanyol Barcelona,32,3,33,30,3,10,6,2
1932,FC Barcelona,26,4,42,34,8,7,6,5
1932,Real Betis,23,5,31,45,-14,6,7,5
1932,Real Sociedad,21,6,41,47,-6,6,9,3
1932,Racing Santander,20,7,47,58,-11,6,10,2
1932,Arenas de Getxo,19,8,39,44,-5,5,9,4
1932,CD Alaves,17,9,21,42,-21,5,11,2
1932,Valencia CF,17,10,34,53,-19,4,9,5
1933,Athletic Bilbao,35,1,61,27,34,11,5,2
1933,Real Madrid,32,2,41,29,12,10,6,2
1933,Real Betis,28,3,29,36,-7,9,8,1
1933,Racing Santander,28,4,38,39,-1,9,8,1
1933,Real Oviedo,26,5,51,45,6,8,8,2
1933,Real Sociedad,25,6,29,33,-4,7,7,4
1933,Espanyol Barcelona,24,7,41,42,-1,7,8,3
1933,Valencia CF,24,8,28,38,-10,7,8,3
1933,FC Barcelona,24,9,42,40,2,8,10,0
1933,Arenas de Getxo,13,10,18,49,-31,3,11,4
1934,Real Madrid,49,1,61,34,27,16,5,1
1934,Real Betis,49,2,43,19,24,15,3,4
1934,Real Oviedo,38,3,60,47,13,12,8,2
1934,Athletic Bilbao,36,4,60,37,23,11,8,3
1934,Sevilla FC,35,5,53,38,15,11,9,2
1934,FC Barcelona,33,6,55,44,11,9,7,6
1934,Valencia CF,29,7,40,49,-9,9,11,2
1934,Atletico Madrid,29,8,40,45,-5,8,9,5
1934,Espanyol Barcelona,29,9,47,59,-12,9,11,2
1934,Racing Santander,24,10,37,46,-9,7,12,3
1934,Real Sociedad,16,11,28,67,-39,5,16,1
1934,Arenas de Getxo,12,12,17,56,-39,3,16,3
1935,Athletic Bilbao,45,1,59,33,26,14,5,3
1935,Real Madrid,42,2,62,35,27,13,6,3
1935,Real Oviedo,40,3,63,47,16,12,6,4
1935,Racing Santander,40,4,58,46,12,13,8,1
1935,Hercules CF,35,5,37,41,-4,11,9,2
1935,FC Barcelona,35,6,39,32,7,11,9,2
1935,Real Betis,29,7,31,46,-15,9,11,2
1935,Valencia CF,26,8,36,42,-6,7,10,5
1935,Espanyol Barcelona,25,9,36,53,-17,8,13,1
1935,Sevilla FC,22,10,27,48,-21,6,12,4
1935,Atletico Madrid,21,11,34,50,-16,6,13,3
1935,CA Osasuna,21,12,46,55,-9,7,15,0
1939,Atletico Madrid,43,1,43,29,14,14,7,1
1939,Sevilla FC,39,2,60,44,16,11,5,6
1939,Athletic Bilbao,37,3,57,44,13,11,7,4
1939,Real Madrid,37,4,47,35,12,12,9,1
1939,Espanyol Barcelona,35,5,43,43,0,11,9,2
1939,Hercules CF,32,6,41,34,7,9,8,5
1939,Valencia CF,30,7,40,36,4,9,10,3
1939,Real Zaragoza,28,8,30,40,-10,7,8,7
1939,Celta Vigo,28,9,45,50,-5,9,12,1
1939,FC Barcelona,27,10,32,38,-6,8,11,3
1939,Real Betis,22,11,26,51,-25,6,12,4
1939,Racing Santander,19,12,37,57,-20,6,15,1
1940,Atletico Madrid,46,1,70,36,34,13,2,7
1940,Athletic Bilbao,44,2,49,24,25,13,4,5
1940,FC Barcelona,40,3,55,45,10,13,8,1
1940,Sevilla FC,38,4,70,43,27,12,8,2
1940,Valencia CF,38,5,60,52,8,11,6,5
1940,Real Madrid,35,6,51,38,13,11,9,2
1940,Espanyol Barcelona,32,7,50,54,-4,10,10,2
1940,Hercules CF,23,8,28,67,-39,7,13,2
1940,Real Oviedo,23,9,36,63,-27,7,13,2
1940,Celta Vigo,22,10,45,51,-6,7,14,1
1940,Real Zaragoza,19,11,26,41,-15,5,13,4
1940,Real Murcia,18,12,29,55,-26,5,14,3
1941,Valencia CF,58,1,85,39,46,18,4,4
1941,Atletico Madrid,47,2,50,44,6,14,7,5
1941,Real Madrid,47,3,65,43,22,14,7,5
1941,Deportivo La Coruna,40,4,36,37,-1,12,10,4
1941,Celta Vigo,39,5,53,58,-5,11,9,6
1941,Athletic Bilbao,37,6,55,41,14,10,9,7
1941,Sevilla FC,37,7,58,45,13,10,9,7
1941,CD Castellon,36,8,54,63,-9,10,10,6
1941,Espanyol Barcelona,36,9,49,42,7,10,10,6
1941,Granada CF,35,10,64,52,12,10,11,5
1941,Real Oviedo,31,11,42,63,-21,8,11,7
1941,FC Barcelona,27,12,57,66,-9,8,15,3
1941,Hercules CF,23,13,42,71,-29,6,15,5
1941,Real Sociedad,17,14,31,77,-46,5,19,2
1942,Athletic Bilbao,52,1,73,38,35,16,6,4
1942,Sevilla FC,48,2,63,47,16,15,8,3
1942,FC Barcelona,46,3,77,50,27,14,8,4
1942,Celta Vigo,44,4,52,50,2,14,10,2
1942,CD Castellon,44,5,41,43,-2,13,8,5
1942,Real Oviedo,40,6,53,63,-10,12,10,4
1942,Atletico Madrid,38,7,54,44,10,11,10,5
1942,Valencia CF,37,8,58,45,13,10,9,7
1942,Real Madrid,35,9,52,50,2,10,11,5
1942,Espanyol Barcelona,33,10,45,51,-6,9,11,6
1942,Deportivo La Coruna,33,11,35,32,3,7,7,12
1942,Granada CF,31,12,56,68,-12,9,13,4
1942,Real Zaragoza,15,13,25,57,-32,2,15,9
1942,Real Betis,12,14,28,74,-46,2,18,6
1943,Valencia CF,58,1,73,32,41,18,4,4
1943,Atletico Madrid,49,2,66,49,17,15,7,4
1943,Sevilla FC,44,3,60,46,14,12,6,8
1943,CD Castellon,42,4,42,36,6,13,10,3
1943,Real Oviedo,41,5,71,47,24,12,9,5
1943,Real Madrid,39,6,48,38,10,11,9,6
1943,FC Barcelona,38,7,59,46,13,10,8,8
1943,CE Sabadell,36,8,53,60,-7,11,12,3
1943,Granada CF,35,9,41,46,-5,9,9,8
1943,Athletic Bilbao,35,10,47,51,-4,10,11,5
1943,Espanyol Barcelona,32,11,42,50,-8,9,12,5
1943,Deportivo La Coruna,25,12,35,64,-29,6,13,7
1943,Real Sociedad,22,13,34,54,-20,5,14,7
1943,Celta Vigo,11,14,23,75,-52,2,19,5
1944,FC Barcelona,56,1,50,30,20,17,4,5
1944,Real Madrid,56,2,68,35,33,18,6,2
1944,Athletic Bilbao,44,3,54,41,13,14,10,2
1944,Atletico Madrid,44,4,46,41,5,13,8,5
1944,Real Oviedo,44,5,50,48,2,13,8,5
1944,Valencia CF,42,6,61,35,26,12,8,6
1944,CD Castellon,34,7,43,50,-7,10,12,4
1944,Espanyol Barcelona,33,8,44,39,5,10,13,3
1944,Sporting Gijon,33,9,42,46,-4,9,11,6
1944,Sevilla FC,31,10,52,49,3,9,13,4
1944,Real Murcia,26,11,40,58,-18,7,14,5
1944,Granada CF,26,12,40,55,-15,7,14,5
1944,CE Sabadell,23,13,30,67,-37,6,15,5
1944,Deportivo La Coruna,22,14,36,62,-26,5,14,7
1945,Sevilla FC,50,1,53,37,16,14,4,8
1945,FC Barcelona,49,2,48,31,17,14,5,7
1945,Athletic Bilbao,47,3,63,38,25,14,7,5
1945,Real Madrid,42,4,46,30,16,11,6,9
1945,Real Oviedo,40,5,44,37,7,10,6,10
1945,Valencia CF,37,6,44,36,8,9,7,10
1945,CD Castellon,37,7,38,54,-16,11,11,4
1945,Atletico Madrid,36,8,50,48,2,10,10,6
1945,Sporting Gijon,34,9,37,39,-2,9,10,7
1945,Celta Vigo,30,10,57,56,1,9,14,3
1945,CD Alcoyano,26,11,39,54,-15,7,14,5
1945,Real Murcia,25,12,21,39,-18,5,11,10
1945,Espanyol Barcelona,25,13,41,53,-12,6,13,7
1945,Hercules CF,20,14,30,59,-29,5,16,5
1946,Valencia CF,50,1,54,34,20,16,8,2
1946,Athletic Bilbao,49,2,72,38,34,15,7,4
1946,Atletico Madrid,45,3,58,44,14,13,7,6
1946,FC Barcelona,45,4,59,42,17,14,9,3
1946,Sevilla FC,41,5,54,48,6,12,9,5
1946,CE Sabadell,41,6,42,36,6,11,7,8
1946,Real Madrid,38,7,62,56,6,11,10,5
1946,Real Oviedo,37,8,52,42,10,10,9,7
1946,Celta Vigo,37,9,53,48,5,11,11,4
1946,Sporting Gijon,35,10,51,59,-8,10,11,5
1946,Espanyol Barcelona,28,11,46,59,-13,9,16,1
1946,Real Murcia,25,12,30,58,-28,6,13,7
1946,Deportivo La Coruna,23,13,32,60,-28,5,13,8
1946,CD Castellon,17,14,39,80,-41,4,17,5
1947,FC Barcelona,52,1,65,31,34,15,4,7
1947,Valencia CF,49,2,59,34,25,15,7,4
1947,Atletico Madrid,46,3,73,45,28,13,6,7
1947,Celta Vigo,45,4,59,48,11,14,9,3
1947,Sevilla FC,41,5,50,40,10,12,9,5
1947,Athletic Bilbao,40,6,56,44,12,12,10,4
1947,Gimnastic,34,7,49,55,-6,10,12,4
1947,Espanyol Barcelona,33,8,39,47,-8,9,11,6
1947,Real Oviedo,32,9,49,57,-8,9,12,5
1947,CD Alcoyano,31,10,40,52,-12,9,13,4
1947,CE Sabadell,30,11,41,62,-21,9,14,3
1947,Real Madrid,28,12,41,56,-15,7,12,7
1947,Real Sociedad,27,13,38,56,-18,8,15,3
1947,Sporting Gijon,25,14,37,69,-32,7,15,4
1948,FC Barcelona,53,1,66,36,30,16,5,5
1948,Valencia CF,51,2,78,47,31,16,7,3
1948,Atletico Madrid,49,3,54,32,22,15,7,4
1948,Real Madrid,49,4,67,42,25,15,7,4
1948,Real Oviedo,43,5,50,43,7,13,9,4
1948,Athletic Bilbao,35,6,61,63,-2,11,13,2
1948,Sevilla FC,34,7,35,40,-5,11,14,1
1948,Espanyol Barcelona,34,8,51,46,5,10,12,4
1948,Gimnastic,33,9,59,72,-13,10,13,3
1948,Real Valladolid,32,10,38,59,-21,10,14,2
1948,Celta Vigo,31,11,51,64,-13,9,13,4
1948,Deportivo La Coruna,31,12,56,60,-4,9,13,4
1948,CD Alcoyano,29,13,30,54,-24,8,13,5
1948,CE Sabadell,18,14,43,81,-38,5,18,3
1949,Atletico Madrid,48,1,71,51,20,15,8,3
1949,Deportivo La Coruna,44,2,48,38,10,12,6,8
1949,Valencia CF,43,3,71,43,28,12,7,7
1949,Real Madrid,42,4,60,49,11,11,6,9
1949,FC Barcelona,42,5,67,47,20,13,10,3
1949,Athletic Bilbao,41,6,72,66,6,12,9,5
1949,Celta Vigo,41,7,63,50,13,13,11,2
1949,Real Sociedad,36,8,57,43,14,9,8,9
1949,Sevilla FC,36,9,60,61,-1,11,12,3
1949,Real Valladolid,33,10,49,46,3,8,9,9
1949,Espanyol Barcelona,30,11,42,64,-22,8,12,6
1949,CD Malaga,29,12,44,51,-7,8,13,5
1949,Gimnastic,23,13,39,99,-60,7,17,2
1949,Real Oviedo,19,14,30,65,-35,4,15,7
1950,Atletico Madrid,57,1,87,50,37,17,7,6
1950,Sevilla FC,55,2,79,46,33,17,9,4
1950,Valencia CF,54,3,64,48,16,17,10,3
1950,FC Barcelona,51,4,83,61,22,16,11,3
1950,Real Sociedad,50,5,77,56,21,15,10,5
1950,Athletic Bilbao,48,6,88,56,32,15,12,3
1950,Celta Vigo,48,7,62,56,6,15,12,3
1950,Real Valladolid,47,8,51,51,0,14,11,5
1950,Real Madrid,44,9,80,71,9,13,12,5
1950,Deportivo La Coruna,43,10,64,47,17,13,13,4
1950,Espanyol Barcelona,43,11,82,72,10,13,13,4
1950,Racing Santander,42,12,49,60,-11,12,12,6
1950,CD Malaga,41,13,55,52,3,12,13,5
1950,Real Murcia,27,14,40,86,-46,8,19,3
1950,CD Alcoyano,20,15,36,92,-56,6,22,2
1950,UE Lleida,19,16,41,134,-93,6,23,1
1951,FC Barcelona,62,1,92,43,49,19,6,5
1951,Athletic Bilbao,57,2,78,46,32,17,7,6
1951,Real Madrid,54,3,79,50,29,16,8,6
1951,Atletico Madrid,53,4,80,57,23,16,9,5
1951,Valencia CF,50,5,68,51,17,15,10,5
1951,Espanyol Barcelona,46,6,69,62,7,14,12,4
1951,Sevilla FC,46,7,69,57,12,14,12,4
1951,Celta Vigo,39,8,64,66,-2,12,15,3
1951,Real Valladolid,38,9,47,43,4,9,10,11
1951,Real Sociedad,37,10,60,59,1,11,15,4
1951,Deportivo La Coruna,35,11,46,70,-24,10,15,5
1951,Sporting Gijon,35,12,49,75,-26,10,15,5
1951,Real Zaragoza,35,13,54,73,-19,10,15,5
1951,Racing Santander,34,14,45,65,-20,9,14,7
1951,UD Las Palmas,31,15,36,85,-49,9,17,4
1951,Atletico Tetuan,26,16,51,85,-34,7,18,5
1952,FC Barcelona,61,1,82,43,39,19,7,4
1952,Real Madrid,57,2,67,49,18,18,9,3
1952,Valencia CF,56,3,66,42,24,16,6,8
1952,Espanyol Barcelona,52,4,64,40,24,16,10,4
1952,Sevilla FC,50,5,70,57,13,16,12,2
1952,Athletic Bilbao,46,6,83,52,31,14,12,4
1952,Atletico Madrid,43,7,65,70,-5,13,13,4
1952,Sporting Gijon,41,8,39,54,-15,11,11,8
1952,Real Oviedo,41,9,63,62,1,12,13,5
1952,Real Sociedad,38,10,54,61,-7,10,12,8
1952,Racing Santander,38,11,46,61,-15,11,14,5
1952,Celta Vigo,35,12,54,69,-15,10,15,5
1952,Real Valladolid,35,13,48,54,-6,10,15,5
1952,Deportivo La Coruna,33,14,49,78,-29,9,15,6
1952,CD Malaga,32,15,47,69,-22,10,18,2
1952,Real Zaragoza,23,16,38,74,-36,6,19,5
1953,Real Madrid,57,1,72,41,31,17,7,6
1953,FC Barcelona,52,2,74,39,35,16,10,4
1953,Espanyol Barcelona,48,3,50,36,14,14,10,6
1953,Valencia CF,48,4,69,51,18,14,10,6
1953,Sevilla FC,47,5,57,49,8,15,13,2
1953,Athletic Bilbao,44,6,54,44,10,12,10,8
1953,Deportivo La Coruna,44,7,41,46,-5,13,12,5
1953,Racing Santander,43,8,53,61,-8,12,11,7
1953,Celta Vigo,41,9,47,54,-7,12,13,5
1953,Real Valladolid,41,10,50,60,-10,12,13,5
1953,Real Sociedad,40,11,44,58,-14,11,12,7
1953,CA Osasuna,40,12,46,54,-8,12,14,4
1953,Atletico Madrid,40,13,57,47,10,11,12,7
1953,Real Jaen,39,14,55,70,-15,11,13,6
1953,Real Oviedo,30,15,31,53,-22,8,16,6
1953,Sporting Gijon,23,16,44,81,-37,7,21,2
1954,Real Madrid,66,1,80,31,49,20,4,6
1954,FC Barcelona,58,2,75,39,36,17,6,7
1954,Athletic Bilbao,54,3,78,39,39,15,6,9
1954,Sevilla FC,49,4,74,58,16,15,11,4
1954,Valencia CF,48,5,71,60,11,15,12,3
1954,Deportivo La Coruna,42,6,52,59,-7,12,12,6
1954,Hercules CF,42,7,46,57,-11,11,10,9
1954,Atletico Madrid,40,8,59,64,-5,11,12,7
1954,Real Valladolid,38,9,48,56,-8,11,14,5
1954,CD Alaves,38,10,51,62,-11,11,14,5
1954,UD Las Palmas,37,11,45,69,-24,10,13,7
1954,Celta Vigo,37,12,55,60,-5,10,13,7
1954,Espanyol Barcelona,34,13,42,46,-4,8,12,10
1954,Real Sociedad,33,14,48,53,-5,9,15,6
1954,Racing Santander,29,15,39,81,-42,9,19,2
1954,CD Malaga,25,16,36,65,-29,6,17,7
1955,Athletic Bilbao,70,1,79,31,48,22,4,4
1955,FC Barcelona,69,2,67,26,41,22,5,3
1955,Real Madrid,56,3,81,39,42,18,10,2
1955,Sevilla FC,53,4,75,44,31,17,11,2
1955,Atletico Madrid,47,5,75,49,26,14,11,5
1955,Espanyol Barcelona,45,6,50,56,-6,14,13,3
1955,Valencia CF,45,7,58,50,8,13,11,6
1955,Real Valladolid,43,8,52,55,-3,13,13,4
1955,Real Sociedad,41,9,48,53,-5,11,11,8
1955,Celta Vigo,39,10,52,75,-23,12,15,3
1955,UD Las Palmas,37,11,49,60,-11,11,15,4
1955,Deportivo La Coruna,37,12,60,80,-20,11,15,4
1955,Real Murcia,35,13,46,66,-20,10,15,5
1955,CD Alaves,33,14,49,73,-24,9,15,6
1955,CD Leonesa,19,15,34,65,-31,5,21,4
1955,Hercules CF,18,16,33,86,-53,5,22,3
1956,Real Madrid,64,1,74,35,39,20,6,4
1956,Sevilla FC,56,2,64,49,15,17,8,5
1956,FC Barcelona,55,3,70,37,33,16,7,7
1956,Athletic Bilbao,53,4,59,45,14,16,9,5
1956,Atletico Madrid,49,5,65,45,20,15,11,4
1956,CA Osasuna,43,6,40,38,2,12,11,7
1956,Espanyol Barcelona,41,7,39,48,-9,11,11,8
1956,Real Zaragoza,39,8,37,51,-14,11,13,6
1956,Real Valladolid,39,9,52,58,-6,11,13,6
1956,Valencia CF,37,10,43,46,-3,10,13,7
1956,UD Las Palmas,36,11,41,58,-17,9,12,9
1956,Real Sociedad,35,12,39,47,-8,9,13,8
1956,Deportivo La Coruna,32,13,41,61,-20,10,18,2
1956,Real Jaen,32,14,37,55,-18,9,16,5
1956,Celta Vigo,31,15,39,47,-8,8,15,7
1956,CD Condal,29,16,37,57,-20,7,15,8
1957,Real Madrid,65,1,71,26,45,20,5,5
1957,Atletico Madrid,58,2,78,43,35,16,4,10
1957,FC Barcelona,55,3,69,38,31,17,9,4
1957,CA Osasuna,50,4,53,43,10,15,10,5
1957,Valencia CF,49,5,56,40,16,13,7,10
1957,Athletic Bilbao,46,6,56,48,8,14,12,4
1957,Celta Vigo,45,7,50,51,-1,13,11,6
1957,Espanyol Barcelona,39,8,48,46,2,11,13,6
1957,Real Sociedad,37,9,38,44,-6,10,13,7
1957,Granada CF,35,10,35,53,-18,11,17,2
1957,Sporting Gijon,34,11,46,57,-11,10,16,4
1957,UD Las Palmas,34,12,34,65,-31,9,14,7
1957,Sevilla FC,34,13,45,55,-10,9,14,7
1957,Real Valladolid,32,14,45,73,-28,9,16,5
1957,Real Zaragoza,32,15,39,52,-13,8,14,8
1957,Real Jaen,29,16,29,58,-29,9,19,2
1958,FC Barcelona,75,1,96,26,70,24,3,3
1958,Real Madrid,68,2,89,29,60,21,4,5
1958,Athletic Bilbao,53,3,72,33,39,17,11,2
1958,Real Betis,46,4,54,53,1,14,12,4
1958,Valencia CF,46,5,47,41,6,13,10,7
1958,Atletico Madrid,45,6,58,48,10,13,11,6
1958,Real Zaragoza,40,7,47,60,-13,12,14,4
1958,CA Osasuna,40,8,44,59,-15,12,14,4
1958,Espanyol Barcelona,40,9,42,45,-3,11,12,7
1958,Sevilla FC,38,10,44,58,-14,12,16,2
1958,Real Oviedo,38,11,31,49,-18,11,14,5
1958,Real Sociedad,37,12,32,33,-1,9,11,10
1958,Granada CF,37,13,30,43,-13,11,15,4
1958,UD Las Palmas,34,14,43,69,-26,10,16,4
1958,Sporting Gijon,27,15,25,70,-45,7,17,6
1958,Celta Vigo,17,16,21,59,-38,4,21,5
1959,FC Barcelona,68,1,86,28,58,22,6,2
1959,Real Madrid,67,2,92,36,56,21,5,4
1959,Athletic Bilbao,58,3,74,45,29,19,10,1
1959,Sevilla FC,52,4,63,44,19,16,10,4
1959,Atletico Madrid,48,5,59,40,19,15,12,3
1959,Real Betis,48,6,42,53,-11,15,12,3
1959,Real Oviedo,46,7,38,51,-13,13,10,7
1959,Espanyol Barcelona,41,8,33,29,4,11,11,8
1959,Valencia CF,39,9,37,33,4,11,13,6
1959,Elche CF,38,10,41,64,-23,11,14,5
1959,Real Valladolid,36,11,48,61,-13,11,16,3
1959,Granada CF,35,12,38,52,-14,10,15,5
1959,Real Zaragoza,35,13,49,58,-9,10,15,5
1959,Real Sociedad,33,14,41,61,-20,10,17,3
1959,CA Osasuna,26,15,42,75,-33,8,20,2
1959,UD Las Palmas,18,16,24,77,-53,5,22,3
1960,Real Madrid,76,1,89,25,64,24,2,4
1960,Atletico Madrid,57,2,57,35,22,17,7,6
1960,FC Barcelona,45,3,62,47,15,13,11,6
1960,Real Zaragoza,45,4,54,53,1,12,9,9
1960,Valencia CF,43,5,46,42,4,11,9,10
1960,Athletic Bilbao,42,6,42,41,1,12,12,6
1960,Real Betis,41,7,42,44,-2,11,11,8
1960,Real Sociedad,40,8,37,46,-9,10,10,10
1960,RCD Mallorca,40,9,38,41,-3,12,14,4
1960,Espanyol Barcelona,39,10,46,46,0,12,15,3
1960,Racing Santander,37,11,42,47,-5,11,15,4
1960,Real Valladolid,36,12,39,52,-13,11,16,3
1960,Sevilla FC,36,13,42,46,-4,9,12,9
1960,Real Oviedo,36,14,39,54,-15,10,14,6
1960,Elche CF,34,15,48,75,-27,9,14,7
1960,Granada CF,22,16,32,61,-29,5,18,7
1961,Real Madrid,62,1,58,24,34,19,6,5
1961,FC Barcelona,58,2,81,46,35,18,8,4
1961,Atletico Madrid,51,3,50,36,14,15,9,6
1961,Real Zaragoza,50,4,70,51,19,15,10,5
1961,Athletic Bilbao,44,5,52,38,14,12,10,8
1961,Valencia CF,43,6,50,50,0,12,11,7
1961,Sevilla FC,43,7,48,45,3,12,11,7
1961,Elche CF,39,8,52,52,0,10,11,9
1961,Real Betis,38,9,39,51,-12,10,12,8
1961,RCD Mallorca,38,10,30,47,-17,11,14,5
1961,Real Oviedo,37,11,27,47,-20,10,13,7
1961,CA Osasuna,37,12,54,59,-5,10,13,7
1961,Racing Santander,37,13,35,54,-19,11,15,4
1961,Espanyol Barcelona,34,14,45,55,-10,8,12,10
1961,Real Sociedad,32,15,37,49,-12,9,16,5
1961,CD Tenerife,25,16,33,57,-24,6,17,7
1962,Real Madrid,72,1,83,33,50,23,4,3
1962,Atletico Madrid,51,2,61,36,25,14,7,9
1962,Real Oviedo,48,3,52,46,6,15,12,3
1962,Real Valladolid,48,4,51,53,-2,15,12,3
1962,Real Zaragoza,46,5,54,39,15,14,12,4
1962,Valencia CF,45,6,49,36,13,14,13,3
1962,FC Barcelona,42,7,45,36,9,11,10,9
1962,Real Betis,40,8,41,47,-6,12,14,4
1962,Elche CF,40,9,48,59,-11,11,12,7
1962,Cordoba CF,39,10,35,39,-4,12,15,3
1962,Athletic Bilbao,38,11,41,40,1,10,12,8
1962,Sevilla FC,38,12,40,55,-15,11,14,5
1962,RCD Mallorca,37,13,47,57,-10,11,15,4
1962,Deportivo La Coruna,36,14,33,48,-15,11,16,3
1962,CA Osasuna,33,15,39,50,-11,9,15,6
1962,CD Malaga,28,16,25,70,-45,8,18,4
1963,Real Madrid,68,1,61,23,38,22,6,2
1963,FC Barcelona,61,2,74,38,36,19,7,4
1963,Real Betis,52,3,47,36,11,15,8,7
1963,Real Zaragoza,48,4,52,42,10,14,10,6
1963,Valencia CF,48,5,53,47,6,16,14,0
1963,Elche CF,46,6,35,31,4,13,10,7
1963,Athletic Bilbao,41,7,43,40,3,12,13,5
1963,Atletico Madrid,39,8,37,34,3,10,11,9
1963,Sevilla FC,38,9,33,38,-5,9,10,11
1963,Real Murcia,37,10,41,54,-13,11,15,4
1963,Levante UD,37,11,43,56,-13,10,13,7
1963,Cordoba CF,36,12,32,38,-6,10,14,6
1963,Espanyol Barcelona,35,13,34,47,-13,10,15,5
1963,Real Oviedo,35,14,27,42,-15,10,15,5
1963,Pontevedra CF,29,15,30,45,-15,8,17,5
1963,Real Valladolid,26,16,27,58,-31,7,18,5
1964,Real Madrid,68,1,64,18,46,21,4,5
1964,Atletico Madrid,63,2,58,27,31,20,7,3
1964,Real Zaragoza,59,3,60,37,23,19,9,2
1964,Valencia CF,55,4,59,37,22,17,9,4
1964,Cordoba CF,51,5,36,34,2,16,11,3
1964,FC Barcelona,46,6,59,41,18,14,12,4
1964,Athletic Bilbao,45,7,36,41,-5,13,11,6
1964,Elche CF,45,8,38,43,-5,14,13,3
1964,UD Las Palmas,40,9,36,43,-7,11,12,7
1964,Espanyol Barcelona,37,10,37,39,-2,12,17,1
1964,Sevilla FC,37,11,38,50,-12,11,15,4
1964,Real Betis,31,12,33,45,-12,8,15,7
1964,Levante UD,29,13,37,51,-14,8,17,5
1964,Real Murcia,28,14,28,49,-21,5,12,13
1964,Real Oviedo,27,15,22,54,-32,7,17,6
1964,Deportivo La Coruna,21,16,18,50,-32,6,21,3
1965,Real Madrid,62,1,53,30,23,19,6,5
1965,Atletico Madrid,62,2,54,20,34,18,4,8
1965,FC Barcelona,54,3,51,27,24,16,8,6
1965,Real Zaragoza,50,4,47,29,18,14,8,8
1965,Athletic Bilbao,48,5,43,32,11,14,10,6
1965,Elche CF,44,6,36,37,-1,12,10,8
1965,Pontevedra CF,44,7,31,34,-3,13,12,5
1965,Valencia CF,38,8,40,35,5,11,14,5
1965,Sevilla FC,36,9,27,38,-11,9,12,9
1965,UD Las Palmas,35,10,32,39,-7,9,13,8
1965,Cordoba CF,35,11,34,42,-8,10,15,5
1965,CE Sabadell,33,12,30,46,-16,10,17,3
1965,CD Malaga,32,13,24,37,-13,8,14,8
1965,RCD Mallorca,32,14,40,55,-15,9,16,5
1965,Espanyol Barcelona,31,15,31,48,-17,7,13,10
1965,Real Betis,30,16,36,60,-24,7,14,9
1966,Real Madrid,66,1,58,22,36,19,2,9
1966,FC Barcelona,62,2,58,29,29,20,8,2
1966,Espanyol Barcelona,52,3,50,40,10,15,8,7
1966,Atletico Madrid,49,4,57,30,27,14,9,7
1966,Real Zaragoza,48,5,51,50,1,14,10,6
1966,Valencia CF,46,6,58,37,21,14,12,4
1966,Athletic Bilbao,42,7,43,36,7,11,10,9
1966,CE Sabadell,41,8,35,38,-3,11,11,8
1966,Elche CF,36,9,41,50,-9,9,12,9
1966,Pontevedra CF,36,10,28,32,-4,9,12,9
1966,Cordoba CF,35,11,28,44,-16,9,13,8
1966,UD Las Palmas,34,12,32,38,-6,8,12,10
1966,Sevilla FC,34,13,28,47,-19,9,14,7
1966,Granada CF,31,14,32,46,-14,8,15,7
1966,Hercules CF,26,15,32,60,-28,6,16,8
1966,Deportivo La Coruna,25,16,25,57,-32,7,19,4
1967,Real Madrid,58,1,55,26,29,16,4,10
1967,UD Las Palmas,55,2,56,41,15,17,9,4
1967,FC Barcelona,54,3,48,29,19,15,6,9
1967,Valencia CF,47,4,52,38,14,13,9,8
1967,Real Zaragoza,46,5,43,34,9,13,10,7
1967,Atletico Madrid,45,6,38,32,6,12,9,9
1967,Athletic Bilbao,43,7,51,28,23,11,9,10
1967,Pontevedra CF,43,8,36,41,-5,12,11,7
1967,Espanyol Barcelona,41,9,48,44,4,12,13,5
1967,Elche CF,38,10,30,39,-9,11,14,5
1967,CE Sabadell,36,11,34,51,-17,10,14,6
1967,Cordoba CF,36,12,35,57,-22,11,16,3
1967,CD Malaga,36,13,29,37,-8,9,12,9
1967,Real Sociedad,33,14,38,43,-5,9,15,6
1967,Real Betis,28,15,30,58,-28,8,18,4
1967,Sevilla FC,26,16,31,56,-25,6,16,8
1968,Real Madrid,65,1,46,21,25,18,1,11
1968,UD Las Palmas,53,2,45,34,11,15,7,8
1968,FC Barcelona,49,3,40,18,22,13,7,10
1968,CE Sabadell,42,4,33,34,-1,10,8,12
1968,Valencia CF,41,5,36,39,-3,10,9,11
1968,Granada CF,40,6,26,38,-12,11,12,7
1968,Atletico Madrid,40,7,40,37,3,10,10,10
1968,Deportivo La Coruna,39,8,39,44,-5,11,13,6
1968,Real Sociedad,39,9,36,33,3,10,11,9
1968,Athletic Bilbao,38,10,42,46,-4,10,12,8
1968,Elche CF,36,11,25,23,2,7,8,15
1968,CD Malaga,34,12,37,42,-5,9,14,7
1968,Pontevedra CF,34,13,20,23,-3,7,10,13
1968,Real Zaragoza,34,14,36,36,0,8,12,10
1968,Espanyol Barcelona,32,15,29,36,-7,8,14,8
1968,Cordoba CF,26,16,31,57,-26,5,14,11
1969,Atletico Madrid,60,1,53,22,31,18,6,6
1969,Athletic Bilbao,58,2,44,20,24,17,6,7
1969,Valencia CF,50,3,35,23,12,15,10,5
1969,Sevilla FC,49,4,39,32,7,14,9,7
1969,Real Madrid,48,5,50,42,8,13,8,9
1969,Real Sociedad,48,6,47,37,10,15,12,3
1969,FC Barcelona,48,7,40,31,9,13,8,9
1969,Real Zaragoza,46,8,35,39,-4,13,10,7
1969,UD Las Palmas,37,9,32,40,-8,10,13,7
1969,Celta Vigo,37,10,31,39,-8,10,13,7
1969,CE Sabadell,35,11,31,37,-6,10,15,5
1969,Elche CF,34,12,32,44,-12,8,12,10
1969,Granada CF,34,13,20,31,-11,8,12,10
1969,Deportivo La Coruna,33,14,25,32,-7,8,13,9
1969,RCD Mallorca,29,15,33,52,-19,7,15,8
1969,Pontevedra CF,17,16,20,46,-26,4,21,5
1970,FC Barcelona,62,1,50,22,28,19,6,5
1970,Valencia CF,61,2,41,19,22,18,5,7
1970,Atletico Madrid,59,3,51,20,31,17,5,8
1970,Real Madrid,58,4,46,24,22,17,6,7
1970,Celta Vigo,50,5,37,32,5,15,10,5
1970,Athletic Bilbao,49,6,40,31,9,14,9,7
1970,Sevilla FC,45,7,34,42,-8,13,11,6
1970,Real Sociedad,39,8,23,27,-4,10,11,9
1970,Granada CF,38,9,33,34,-1,10,12,8
1970,CD Malaga,36,10,27,32,-5,8,10,12
1970,Sporting Gijon,35,11,35,44,-9,10,15,5
1970,Espanyol Barcelona,33,12,18,25,-7,8,13,9
1970,CE Sabadell,29,13,28,49,-21,8,17,5
1970,UD Las Palmas,25,14,33,42,-9,5,15,10
1970,Elche CF,22,15,25,46,-21,4,16,10
1970,Real Zaragoza,18,16,22,54,-32,3,18,9
1971,Real Madrid,66,1,51,27,24,19,6,9
1971,Valencia CF,64,2,53,30,23,19,8,7
1971,FC Barcelona,60,3,40,26,14,17,8,9
1971,UD Las Palmas,53,4,40,36,4,15,11,8
1971,Atletico Madrid,53,5,45,28,17,14,9,11
1971,Granada CF,50,6,40,34,6,14,12,8
1971,Athletic Bilbao,49,7,39,32,7,15,15,4
1971,Real Sociedad,48,8,38,36,2,14,14,6
1971,CD Malaga,44,9,27,31,-4,9,8,17
1971,Sporting Gijon,44,10,41,37,4,12,14,8
1971,Espanyol Barcelona,44,11,43,43,0,12,14,8
1971,Celta Vigo,43,12,37,42,-5,10,11,13
1971,Deportivo La Coruna,41,13,28,38,-10,11,15,8
1971,Burgos CF,40,14,34,42,-8,11,16,7
1971,Real Betis,40,15,25,45,-20,10,14,10
1971,Sevilla FC,36,16,35,45,-10,9,16,9
1971,Cordoba CF,31,17,32,51,-19,6,15,13
1971,CE Sabadell,30,18,27,52,-25,7,18,9
1972,Atletico Madrid,68,1,49,29,20,20,6,8
1972,FC Barcelona,64,2,41,21,20,18,6,10
1972,Espanyol Barcelona,62,3,48,27,21,17,6,11
1972,Real Madrid,60,4,45,29,16,17,8,9
1972,CD Castellon,48,5,44,38,6,13,12,9
1972,Real Sociedad,47,6,37,39,-2,13,13,8
1972,Valencia CF,46,7,37,33,4,12,12,10
1972,Athletic Bilbao,45,8,41,38,3,12,13,9
1972,CD Malaga,44,9,33,29,4,11,12,11
1972,Real Zaragoza,44,10,36,36,0,10,10,14
1972,UD Las Palmas,42,11,38,44,-6,11,14,9
1972,Sporting Gijon,40,12,32,37,-5,11,16,7
1972,Celta Vigo,39,13,30,37,-7,10,15,9
1972,Real Oviedo,39,14,33,44,-11,9,13,12
1972,Granada CF,38,15,25,32,-7,9,14,11
1972,Real Betis,35,16,29,36,-7,7,13,14
1972,Deportivo La Coruna,34,17,22,44,-22,7,14,13
1972,Burgos CF,33,18,36,63,-27,9,19,6
1973,FC Barcelona,71,1,75,24,51,21,5,8
1973,Atletico Madrid,60,2,50,31,19,18,10,6
1973,Real Zaragoza,56,3,51,38,13,16,10,8
1973,Real Sociedad,55,4,46,45,1,16,11,7
1973,Athletic Bilbao,52,5,35,31,4,15,12,7
1973,Granada CF,48,6,34,35,-1,12,10,12
1973,CD Malaga,48,7,31,32,-1,12,10,12
1973,Real Madrid,47,8,48,38,10,13,13,8
1973,UD Las Palmas,47,9,28,35,-7,14,15,5
1973,Espanyol Barcelona,47,10,34,38,-4,13,13,8
1973,Valencia CF,46,11,41,33,8,13,14,7
1973,Sporting Gijon,43,12,49,59,-10,13,17,4
1973,Celta Vigo,42,13,43,49,-6,12,16,6
1973,Elche CF,40,14,25,33,-8,11,16,7
1973,Real Murcia,39,15,27,37,-10,10,15,9
1973,CD Castellon,38,16,28,46,-18,9,14,11
1973,Racing Santander,35,17,36,54,-18,8,15,11
1973,Real Oviedo,33,18,29,52,-23,9,19,6
1974,Real Madrid,70,1,66,34,32,20,4,10
1974,Real Zaragoza,53,2,58,47,11,15,11,8
1974,FC Barcelona,52,3,57,36,21,15,12,7
1974,Real Sociedad,48,4,37,32,5,12,10,12
1974,Real Betis,48,5,35,41,-6,14,14,6
1974,Elche CF,47,6,35,44,-9,13,13,8
1974,Hercules CF,47,7,37,36,1,11,9,14
1974,Espanyol Barcelona,47,8,38,47,-9,14,15,5
1974,Athletic Bilbao,46,9,40,42,-2,13,14,7
1974,Atletico Madrid,46,10,46,34,12,11,10,13
1974,UD Salamanca,45,11,33,29,4,10,9,15
1974,UD Las Palmas,44,12,41,39,2,12,14,8
1974,CD Malaga,44,13,33,42,-9,13,16,5
1974,Valencia CF,44,14,53,48,5,12,14,8
1974,Sporting Gijon,43,15,40,40,0,11,13,10
1974,Granada CF,41,16,35,47,-12,10,13,11
1974,Celta Vigo,40,17,30,41,-11,10,14,10
1974,Real Murcia,30,18,31,66,-35,7,18,9
1975,Real Madrid,68,1,54,26,28,20,6,8
1975,FC Barcelona,61,2,61,41,20,18,9,7
1975,Atletico Madrid,60,3,60,38,22,18,10,6
1975,Espanyol Barcelona,58,4,48,45,3,18,12,4
1975,Athletic Bilbao,53,5,43,38,5,14,9,11
1975,Real Betis,50,6,34,50,-16,15,14,5
1975,Hercules CF,48,7,33,37,-4,12,10,12
1975,Racing Santander,46,8,45,56,-11,14,16,4
1975,Real Sociedad,46,9,45,45,0,12,12,10
1975,UD Salamanca,46,10,31,33,-2,12,12,10
1975,Sevilla FC,45,11,35,39,-4,13,15,6
1975,Valencia CF,44,12,43,41,2,12,14,8
1975,UD Las Palmas,42,13,39,43,-4,12,16,6
1975,Real Zaragoza,41,14,45,43,2,11,15,8
1975,Real Oviedo,38,15,41,45,-4,11,18,5
1975,Elche CF,36,16,38,49,-11,8,14,12
1975,Granada CF,34,17,29,50,-21,8,16,10
1975,Sporting Gijon,31,18,41,46,-5,7,17,10
1976,Atletico Madrid,65,1,62,33,29,19,7,8
1976,FC Barcelona,63,2,69,34,35,18,7,9
1976,Athletic Bilbao,53,3,55,45,10,15,11,8
1976,UD Las Palmas,51,4,56,51,5,15,13,6
1976,Real Betis,51,5,42,42,0,15,13,6
1976,Espanyol Barcelona,50,6,61,59,2,14,12,8
1976,Valencia CF,49,7,53,47,6,13,11,10
1976,Real Sociedad,47,8,54,41,13,13,13,8
1976,Real Madrid,46,9,57,53,4,12,12,10
1976,Burgos CF,46,10,46,50,-4,14,16,4
1976,Sevilla FC,45,11,32,39,-7,11,11,12
1976,UD Salamanca,45,12,30,34,-4,13,15,6
1976,Elche CF,44,13,45,47,-2,11,12,11
1976,Hercules CF,43,14,35,41,-6,11,13,10
1976,Racing Santander,43,15,41,62,-21,12,15,7
1976,Real Zaragoza,40,16,42,51,-9,10,14,10
1976,Celta Vigo,38,17,22,40,-18,9,14,11
1976,CD Malaga,24,18,27,60,-33,6,22,6
1977,Real Madrid,69,1,77,40,37,22,9,3
1977,FC Barcelona,57,2,49,29,20,16,9,9
1977,Athletic Bilbao,56,3,62,36,26,16,10,8
1977,Valencia CF,55,4,54,33,21,16,11,7
1977,Sporting Gijon,54,5,53,43,10,15,10,9
1977,Atletico Madrid,52,6,61,52,9,16,14,4
1977,UD Salamanca,48,7,37,40,-3,14,14,6
1977,Sevilla FC,47,8,38,45,-7,13,13,8
1977,UD Las Palmas,47,9,43,41,2,12,11,11
1977,Real Sociedad,45,10,52,46,6,12,13,9
1977,Rayo Vallecano,45,11,50,59,-9,12,13,9
1977,Racing Santander,42,12,29,45,-16,11,14,9
1977,Espanyol Barcelona,42,13,48,60,-12,12,16,6
1977,Real Betis,41,14,51,52,-1,11,15,8
1977,Burgos CF,41,15,33,47,-14,10,13,11
1977,Hercules CF,40,16,32,40,-8,10,14,10
1977,Elche CF,38,17,44,66,-22,11,18,5
1977,Cadiz CF,29,18,30,69,-39,7,19,8
1978,Real Madrid,63,1,61,36,25,16,3,15
1978,Sporting Gijon,60,2,50,35,15,17,8,9
1978,Real Sociedad,59,3,53,36,17,18,11,5
1978,Atletico Madrid,55,4,55,37,18,14,7,13
1978,FC Barcelona,54,5,69,37,32,16,12,6
1978,UD Las Palmas,51,6,49,43,6,14,11,9
1978,Espanyol Barcelona,50,7,37,46,-9,15,14,5
1978,Valencia CF,49,8,44,39,5,14,13,7
1978,UD Salamanca,47,9,36,40,-4,13,13,8
1978,Athletic Bilbao,46,10,56,46,10,12,12,10
1978,Sevilla FC,45,11,47,48,-1,12,13,9
1978,Hercules CF,45,12,32,38,-6,13,15,6
1978,Burgos CF,42,13,38,47,-9,10,12,12
1978,Real Zaragoza,42,14,56,59,-3,12,16,6
1978,Rayo Vallecano,38,15,31,54,-23,9,14,11
1978,Celta Vigo,37,16,35,55,-20,9,15,10
1978,Racing Santander,31,17,37,63,-26,9,21,4
1978,Recreativo Huelva,29,18,39,66,-27,8,21,5
1979,Real Madrid,75,1,70,33,37,22,3,9
1979,Real Sociedad,71,2,54,20,34,19,1,14
1979,Sporting Gijon,55,3,47,34,13,16,11,7
1979,FC Barcelona,51,4,42,33,9,13,9,12
1979,Athletic Bilbao,50,5,52,44,8,15,14,5
1979,Real Betis,48,6,42,40,2,12,10,12
1979,Sevilla FC,48,7,50,47,3,14,14,6
1979,Valencia CF,48,8,50,42,8,12,10,12
1979,Real Zaragoza,46,9,43,40,3,13,14,7
1979,UD Las Palmas,45,10,36,49,-13,13,15,6
1979,AD Almeria,44,11,42,50,-8,11,12,11
1979,UD Salamanca,44,12,34,37,-3,12,13,8
1979,Atletico Madrid,41,13,38,44,-6,10,13,11
1979,Espanyol Barcelona,39,14,28,37,-9,9,13,12
1979,Hercules CF,36,15,36,39,-3,8,14,12
1979,Rayo Vallecano,35,16,46,61,-15,9,17,8
1979,CD Malaga,30,17,28,56,-28,8,19,6
1979,Burgos CF,25,18,29,61,-32,5,19,10
1980,Real Madrid,65,1,66,37,29,20,9,5
1980,Real Sociedad,64,2,52,29,23,19,8,7
1980,Valencia CF,59,3,59,41,18,17,9,8
1980,FC Barcelona,59,4,66,41,25,18,11,5
1980,Atletico Madrid,58,5,46,39,7,16,8,10
1980,Real Betis,57,6,55,38,17,17,11,6
1980,Sporting Gijon,52,7,58,40,18,14,10,10
1980,Sevilla FC,51,8,34,42,-8,14,11,9
1980,Athletic Bilbao,49,9,64,53,11,14,13,7
1980,Espanyol Barcelona,48,10,37,42,-5,14,14,6
1980,CA Osasuna,44,11,35,46,-11,12,14,8
1980,UD Las Palmas,40,12,47,61,-14,12,18,4
1980,Hercules CF,40,13,42,48,-6,10,14,10
1980,Real Valladolid,40,14,40,46,-6,9,12,13
1980,Real Zaragoza,38,15,31,44,-13,9,14,11
1980,Real Murcia,31,16,35,49,-14,8,19,7
1980,UD Salamanca,28,17,32,67,-35,7,20,7
1980,AD Almeria,25,18,30,66,-36,6,21,7
1981,Real Sociedad,67,1,58,33,25,20,7,7
1981,FC Barcelona,64,2,75,40,35,19,8,7
1981,Real Madrid,62,3,57,34,23,18,8,8
1981,Athletic Bilbao,58,4,63,41,22,18,12,4
1981,Valencia CF,56,5,54,46,8,17,12,5
1981,Real Betis,51,6,53,44,9,15,13,6
1981,Sevilla FC,50,7,52,39,13,15,14,5
1981,Atletico Madrid,49,8,38,37,1,15,15,4
1981,CA Osasuna,48,9,45,45,0,14,14,6
1981,Real Valladolid,47,10,40,53,-13,13,13,8
1981,Real Zaragoza,47,11,45,56,-11,13,13,8
1981,Espanyol Barcelona,45,12,48,55,-7,13,15,6
1981,Racing Santander,44,13,41,52,-11,12,14,8
1981,Cadiz CF,42,14,31,47,-16,13,18,3
1981,UD Las Palmas,40,15,41,53,-12,11,16,7
1981,Sporting Gijon,39,16,38,44,-6,10,15,9
1981,Hercules CF,38,17,41,52,-11,11,18,5
1981,CD Castellon,15,18,33,82,-49,3,25,6
1982,Athletic Bilbao,72,1,71,36,35,22,6,6
1982,Real Madrid,69,2,57,25,32,20,5,9
1982,Atletico Madrid,66,3,56,38,18,20,8,6
1982,FC Barcelona,61,4,60,29,31,17,7,10
1982,Real Zaragoza,57,5,59,39,20,17,11,6
1982,Sevilla FC,57,6,44,31,13,15,7,12
1982,Real Sociedad,48,7,29,27,2,12,10,12
1982,Espanyol Barcelona,45,8,45,47,-2,13,15,6
1982,Sporting Gijon,42,9,31,32,-1,9,10,15
1982,CD Malaga,40,10,37,48,-11,10,14,10
1982,Real Betis,39,11,42,45,-3,9,13,12
1982,Real Valladolid,38,12,34,51,-17,9,14,11
1982,UD Salamanca,38,13,31,48,-17,10,16,8
1982,CA Osasuna,36,14,39,54,-15,10,18,6
1982,Valencia CF,34,15,42,56,-14,9,18,7
1982,Celta Vigo,33,16,27,56,-29,9,19,6
1982,UD Las Palmas,32,17,32,55,-23,7,16,11
1982,Racing Santander,32,18,44,63,-19,9,20,5
1983,Real Madrid,71,1,59,37,22,22,7,5
1983,Athletic Bilbao,69,2,53,30,23,20,5,9
1983,FC Barcelona,68,3,62,28,34,20,6,8
1983,Atletico Madrid,59,4,53,47,6,17,9,8
1983,Real Betis,55,5,45,40,5,17,13,4
1983,Real Sociedad,51,6,43,35,8,14,11,9
1983,Real Zaragoza,47,7,50,41,9,12,11,11
1983,Sevilla FC,47,8,42,43,-1,13,13,8
1983,CD Malaga,44,9,41,35,6,11,12,11
1983,Valencia CF,44,10,45,47,-2,12,14,8
1983,Espanyol Barcelona,43,11,42,44,-2,10,11,13
1983,Real Murcia,42,12,42,38,4,10,12,12
1983,Sporting Gijon,41,13,38,47,-9,11,15,8
1983,Real Valladolid,40,14,44,60,-16,11,16,7
1983,CA Osasuna,39,15,30,44,-14,11,17,6
1983,Cadiz CF,28,16,36,51,-15,6,18,10
1983,UD Salamanca,25,17,30,59,-29,5,19,10
1983,RCD Mallorca,24,18,27,56,-29,3,16,15
1984,FC Barcelona,74,1,69,25,44,21,2,11
1984,Atletico Madrid,59,2,51,28,23,16,7,11
1984,Sporting Gijon,54,3,34,23,11,13,6,15
1984,Athletic Bilbao,54,4,39,26,13,13,6,15
1984,Real Madrid,49,5,46,36,10,13,11,10
1984,CA Osasuna,47,6,38,38,0,13,13,8
1984,Espanyol Barcelona,45,7,40,44,-4,11,11,12
1984,Real Sociedad,45,8,41,33,8,11,11,12
1984,Real Zaragoza,44,9,39,39,0,11,12,11
1984,Valencia CF,42,10,40,37,3,9,10,15
1984,Racing Santander,42,11,27,34,-7,10,12,12
1984,Sevilla FC,41,12,29,41,-12,10,13,11
1984,Real Betis,41,13,37,43,-6,11,15,8
1984,Hercules CF,39,14,28,45,-17,9,13,12
1984,Real Valladolid,37,15,39,45,-6,7,11,16
1984,CD Malaga,36,16,23,36,-13,7,12,15
1984,Elche CF,32,17,18,37,-19,6,14,14
1984,Real Murcia,28,18,24,52,-28,6,18,10
1985,Real Madrid,82,1,83,33,50,26,4,4
1985,FC Barcelona,63,2,61,36,25,18,7,9
1985,Athletic Bilbao,60,3,44,31,13,17,8,9
1985,Atletico Madrid,59,4,53,38,15,17,9,8
1985,Real Zaragoza,57,5,51,34,17,15,7,12
1985,Real Sociedad,56,6,64,51,13,17,12,5
1985,Sporting Gijon,54,7,37,27,10,13,6,15
1985,Sevilla FC,46,8,39,34,5,12,12,10
1985,Real Betis,46,9,40,40,0,11,10,13
1985,Real Valladolid,45,10,54,48,6,13,15,6
1985,Espanyol Barcelona,42,11,43,40,3,11,14,9
1985,Racing Santander,41,12,33,34,-1,10,13,11
1985,CA Osasuna,36,13,24,33,-9,9,16,9
1985,UD Las Palmas,36,14,37,65,-28,9,16,9
1985,Cadiz CF,35,15,30,58,-28,9,17,8
1985,Valencia CF,33,16,38,62,-24,8,17,9
1985,Hercules CF,30,17,35,62,-27,8,20,6
1985,Celta Vigo,19,18,32,72,-40,5,25,4
1986,Real Madrid,93,1,84,37,47,27,5,12
1986,FC Barcelona,87,2,63,29,34,24,5,15
1986,Espanyol Barcelona,71,3,66,46,20,20,13,11
1986,Real Sociedad,66,4,59,54,5,19,16,9
1986,Atletico Madrid,65,5,58,54,4,18,15,11
1986,Real Betis,63,6,61,59,2,18,17,9
1986,Sporting Gijon,61,7,58,50,8,16,15,13
1986,Real Zaragoza,59,8,46,47,-1,15,15,14
1986,Real Murcia,58,9,50,63,-13,17,20,7
1986,Athletic Bilbao,57,10,51,50,1,15,17,12
1986,RCD Mallorca,57,11,48,65,-17,15,17,12
1986,UD Las Palmas,57,12,59,67,-8,16,19,9
1986,Real Valladolid,56,13,42,45,-3,15,18,11
1986,Sevilla FC,53,14,51,53,-2,14,19,11
1986,CA Osasuna,50,15,40,48,-8,12,18,14
1986,CE Sabadell,50,16,38,59,-21,12,18,14
1986,Racing Santander,45,17,46,66,-20,12,23,9
1986,Cadiz CF,39,18,31,59,-28,10,25,9
1987,Real Madrid,90,1,95,26,69,28,4,6
1987,Real Sociedad,73,2,61,33,28,22,9,7
1987,Atletico Madrid,67,3,60,38,22,19,9,10
1987,Athletic Bilbao,63,4,50,43,7,17,9,12
1987,CA Osasuna,55,5,40,34,6,15,13,10
1987,FC Barcelona,54,6,49,44,5,15,14,9
1987,Celta Vigo,53,7,43,40,3,14,13,11
1987,Sporting Gijon,52,8,44,49,-5,14,14,10
1987,Real Valladolid,51,9,31,34,-3,13,13,12
1987,Sevilla FC,50,10,41,46,-5,13,14,11
1987,Real Betis,47,11,42,54,-12,14,19,5
1987,Real Zaragoza,47,12,54,56,-2,11,13,14
1987,Cadiz CF,46,13,47,54,-7,11,14,13
1987,CD Logrones,45,14,28,45,-17,12,17,9
1987,Espanyol Barcelona,44,15,44,55,-11,11,16,11
1987,Valencia CF,43,16,44,53,-9,10,15,13
1987,UD Las Palmas,41,17,43,65,-22,12,21,5
1987,Real Murcia,40,18,31,42,-11,9,16,13
1987,RCD Mallorca,39,19,35,50,-15,9,17,12
1987,CE Sabadell,38,20,27,48,-21,9,18,11
1988,Real Madrid,87,1,91,37,54,25,1,12
1988,FC Barcelona,80,2,80,26,54,23,4,11
1988,Valencia CF,67,3,39,26,13,18,7,13
1988,Atletico Madrid,65,4,69,45,24,19,11,8
1988,Real Valladolid,61,5,40,31,9,18,13,7
1988,Real Zaragoza,58,6,48,42,6,15,10,13
1988,Athletic Bilbao,57,7,45,35,10,15,11,12
1988,Celta Vigo,53,8,42,48,-6,14,13,11
1988,Sevilla FC,51,9,38,39,-1,13,13,12
1988,CA Osasuna,50,10,39,43,-4,13,14,11
1988,Sporting Gijon,48,11,42,42,0,13,16,9
1988,Real Sociedad,47,12,38,47,-9,11,13,14
1988,Real Oviedo,47,13,41,48,-7,12,15,11
1988,CD Malaga,45,14,39,53,-14,12,17,9
1988,CD Logrones,43,15,25,37,-12,9,13,16
1988,Cadiz CF,42,16,31,41,-10,9,14,15
1988,Real Betis,38,17,36,55,-19,9,18,11
1988,Espanyol Barcelona,37,18,29,44,-15,7,15,16
1988,Real Murcia,33,19,27,58,-31,9,23,6
1988,Elche CF,19,20,29,71,-42,4,27,7
1989,Real Madrid,88,1,107,38,69,26,2,10
1989,FC Barcelona,74,2,83,39,44,23,10,5
1989,Valencia CF,73,3,67,42,25,20,5,13
1989,Atletico Madrid,70,4,55,35,20,20,8,10
1989,Sevilla FC,61,5,64,46,18,18,13,7
1989,Real Sociedad,59,6,43,35,8,15,9,14
1989,CD Logrones,59,7,47,51,-4,18,15,5
1989,Real Zaragoza,56,8,52,52,0,16,14,8
1989,CA Osasuna,54,9,42,42,0,14,12,12
1989,Real Oviedo,51,10,41,46,-5,12,11,15
1989,RCD Mallorca,50,11,36,34,2,11,10,17
1989,Athletic Bilbao,48,12,37,39,-2,11,12,15
1989,Sporting Gijon,46,13,37,34,3,12,16,10
1989,Cadiz CF,42,14,28,63,-35,12,20,6
1989,CD Castellon,41,15,30,48,-18,9,15,14
1989,Real Valladolid,38,16,31,41,-10,8,16,14
1989,CD Malaga,37,17,23,50,-27,9,19,10
1989,CD Tenerife,34,18,42,60,-18,8,20,10
1989,Celta Vigo,27,19,24,51,-27,5,21,12
1989,Rayo Vallecano,25,20,32,75,-43,6,25,7
1990,FC Barcelona,82,1,74,33,41,25,6,7
1990,Real Madrid,66,2,63,37,26,20,12,6
1990,Atletico Madrid,64,3,52,28,24,17,8,13
1990,Sporting Gijon,60,4,50,37,13,16,10,12
1990,CA Osasuna,60,5,43,34,9,15,8,15
1990,Real Oviedo,55,6,36,35,1,13,9,16
1990,Valencia CF,55,7,44,40,4,15,13,10
1990,Sevilla FC,53,8,45,47,-2,15,15,8
1990,Athletic Bilbao,51,9,41,50,-9,15,17,6
1990,CD Logrones,50,10,28,35,-7,13,14,11
1990,Real Valladolid,49,11,38,40,-2,12,13,13
1990,CD Tenerife,49,12,37,53,-16,14,17,7
1990,Real Burgos,47,13,32,27,5,10,11,17
1990,Real Sociedad,47,14,39,45,-6,11,13,14
1990,Espanyol Barcelona,46,15,39,47,-8,12,16,10
1990,Real Zaragoza,44,16,36,40,-4,11,16,11
1990,RCD Mallorca,43,17,32,40,-8,9,13,16
1990,CD Castellon,36,18,27,48,-21,8,18,12
1990,Cadiz CF,36,19,29,41,-12,7,16,15
1990,Real Betis,31,20,37,65,-28,6,19,13
1991,FC Barcelona,78,1,87,37,50,23,6,9
1991,Real Madrid,77,2,78,32,46,23,7,8
1991,Atletico Madrid,77,3,67,35,32,24,9,5
1991,Valencia CF,67,4,63,42,21,20,11,7
1991,Real Sociedad,60,5,44,38,6,16,10,12
1991,Real Zaragoza,58,6,40,41,-1,17,14,7
1991,Albacete,56,7,45,47,-2,16,14,8
1991,Sporting Gijon,53,8,37,43,-6,15,15,8
1991,Real Oviedo,50,9,41,46,-5,14,16,8
1991,Real Burgos,49,10,40,43,-3,12,13,13
1991,CD Logrones,49,11,36,51,-15,13,15,10
1991,Sevilla FC,47,12,48,45,3,13,17,8
1991,CD Tenerife,46,13,46,50,-4,12,16,10
1991,Athletic Bilbao,46,14,38,58,-20,13,18,7
1991,Espanyol Barcelona,44,15,43,60,-17,12,18,8
1991,CA Osasuna,43,16,30,40,-10,10,15,13
1991,Deportivo La Coruna,39,17,37,48,-11,8,15,15
1991,RCD Mallorca,37,18,30,49,-19,10,21,7
1991,Cadiz CF,35,19,32,55,-23,7,17,14
1991,Real Valladolid,34,20,31,53,-22,7,18,13
1992,FC Barcelona,83,1,87,34,53,25,5,8
1992,Real Madrid,81,2,75,28,47,24,5,9
1992,Deportivo La Coruna,76,3,67,33,34,22,6,10
1992,Valencia CF,67,4,60,33,27,19,9,10
1992,Sevilla FC,60,5,46,44,2,17,12,9
1992,Atletico Madrid,59,6,52,42,10,16,11,11
1992,CD Tenerife,59,7,59,47,12,15,9,14
1992,Athletic Bilbao,57,8,53,49,4,17,15,6
1992,Real Sociedad,47,9,46,59,-13,13,17,8
1992,Real Zaragoza,46,10,37,52,-15,11,14,13
1992,CA Osasuna,46,11,42,41,1,12,16,10
1992,Sporting Gijon,45,12,38,57,-19,11,15,12
1992,CD Logrones,44,13,32,48,-16,11,16,11
1992,Real Oviedo,43,14,42,52,-10,11,17,10
1992,Celta Vigo,43,15,25,32,-7,9,13,16
1992,Albacete,42,16,54,59,-5,11,18,9
1992,Rayo Vallecano,41,17,40,49,-9,8,13,17
1992,Espanyol Barcelona,38,18,40,56,-16,9,18,11
1992,Cadiz CF,27,19,30,70,-40,5,21,12
1992,Real Burgos,26,20,29,69,-40,4,20,14
1993,FC Barcelona,81,1,91,42,49,25,7,6
1993,Deportivo La Coruna,78,2,54,18,36,22,4,12
1993,Real Zaragoza,65,3,71,47,24,19,11,8
1993,Real Madrid,64,4,61,50,11,19,12,7
1993,Athletic Bilbao,59,5,61,47,14,16,11,11
1993,Sevilla FC,57,6,56,42,14,15,11,12
1993,Valencia CF,54,7,55,50,5,14,12,12
1993,Racing Santander,53,8,44,42,2,15,15,8
1993,CD Tenerife,51,9,50,57,-7,15,17,6
1993,Sporting Gijon,50,10,42,57,-15,15,18,5
1993,Real Oviedo,49,11,43,49,-6,12,13,13
1993,Real Sociedad,48,12,39,47,-8,12,14,12
1993,Atletico Madrid,48,13,54,54,0,13,16,9
1993,Albacete,45,14,49,58,-9,10,13,15
1993,Celta Vigo,44,15,41,51,-10,11,16,11
1993,CD Logrones,42,16,47,58,-11,9,14,15
1993,Rayo Vallecano,40,17,40,58,-18,9,16,13
1993,Real Valladolid,38,18,28,51,-23,8,16,14
1993,UE Lleida,34,19,29,48,-19,7,18,13
1993,CA Osasuna,34,20,34,63,-29,8,20,10
1994,Real Madrid,78,1,76,29,47,23,6,9
1994,Deportivo La Coruna,71,2,68,32,36,20,7,11
1994,FC Barcelona,64,3,60,45,15,18,10,10
1994,Real Betis,61,4,46,25,21,15,7,16
1994,Real Zaragoza,61,5,56,51,5,18,13,7
1994,Sevilla FC,59,6,55,41,14,16,11,11
1994,Athletic Bilbao,58,7,39,42,-3,16,12,10
1994,Espanyol Barcelona,57,8,51,35,16,14,9,15
1994,Real Oviedo,52,9,45,42,3,13,12,13
1994,Valencia CF,51,10,53,48,5,13,13,12
1994,Real Sociedad,50,11,56,44,12,12,12,14
1994,Racing Santander,49,12,42,47,-5,13,15,10
1994,Atletico Madrid,48,13,56,54,2,13,16,9
1994,CD Tenerife,48,14,57,57,0,13,16,9
1994,Celta Vigo,47,15,36,48,-12,11,13,14
1994,SD Compostela,45,16,44,56,-12,11,15,12
1994,Albacete,44,17,44,61,-17,10,14,14
1994,Sporting Gijon,36,18,42,67,-25,8,18,12
1994,Real Valladolid,33,19,25,63,-38,8,21,9
1994,CD Logrones,15,20,15,79,-64,2,27,9
1995,Atletico Madrid,87,1,75,32,43,26,7,9
1995,Valencia CF,83,2,77,51,26,26,11,5
1995,FC Barcelona,80,3,72,39,33,22,6,14
1995,Espanyol Barcelona,74,4,63,36,27,20,8,14
1995,CD Tenerife,72,5,69,54,15,20,10,12
1995,Real Madrid,70,6,75,51,24,20,12,10
1995,Real Sociedad,63,7,62,53,9,17,13,12
1995,Real Betis,62,8,61,54,7,16,12,14
1995,Deportivo La Coruna,61,9,63,44,19,16,13,13
1995,SD Compostela,59,10,47,54,-7,17,17,8
1995,Celta Vigo,52,11,49,51,-2,12,14,16
1995,Sevilla FC,48,12,43,55,-12,11,16,15
1995,Athletic Bilbao,48,13,44,55,-11,11,16,15
1995,Real Zaragoza,48,14,51,59,-8,11,16,15
1995,Real Oviedo,48,15,48,67,-19,12,18,12
1995,Racing Santander,47,16,47,69,-22,11,17,14
1995,Real Valladolid,47,17,57,62,-5,11,17,14
1995,Sporting Gijon,46,18,51,60,-9,13,22,7
1995,Rayo Vallecano,44,19,47,75,-28,12,22,8
1995,Albacete,42,20,55,81,-26,10,20,12
1995,CP Merida,42,21,37,62,-25,10,20,12
1995,UD Salamanca,33,22,53,82,-29,8,25,9
1996,Real Madrid,92,1,85,36,49,27,4,11
1996,FC Barcelona,90,2,102,48,54,28,8,6
1996,Deportivo La Coruna,77,3,57,30,27,21,7,14
1996,Real Betis,77,4,81,46,35,21,7,14
1996,Atletico Madrid,71,5,76,64,12,20,11,11
1996,Real Valladolid,64,6,57,46,11,18,14,10
1996,Athletic Bilbao,64,7,72,57,15,16,10,16
1996,Real Sociedad,63,8,50,47,3,18,15,9
1996,CD Tenerife,56,9,69,57,12,15,16,11
1996,Valencia CF,56,10,63,59,4,15,16,11
1996,SD Compostela,53,11,52,65,-13,13,15,14
1996,Espanyol Barcelona,51,12,51,57,-6,14,19,9
1996,Real Zaragoza,50,13,58,66,-8,12,16,14
1996,Racing Santander,50,14,52,54,-2,11,14,17
1996,Sporting Gijon,50,15,45,63,-18,13,18,11
1996,Celta Vigo,49,16,51,54,-3,12,17,13
1996,Real Oviedo,48,17,49,65,-16,12,18,12
1996,Rayo Vallecano,45,18,43,62,-19,13,23,6
1996,CF Extremadura,44,19,35,64,-29,11,20,11
1996,Sevilla FC,43,20,50,69,-19,12,23,7
1996,Hercules CF,41,21,40,77,-37,12,25,5
1996,CD Logrones,33,22,33,85,-52,9,27,6
1997,FC Barcelona,74,1,78,56,22,23,10,5
1997,Athletic Bilbao,65,2,52,42,10,17,7,14
1997,Real Madrid,63,3,63,45,18,17,9,12
1997,Real Sociedad,63,4,60,37,23,16,7,15
1997,Celta Vigo,60,5,54,47,7,17,12,9
1997,Atletico Madrid,60,6,79,56,23,16,10,12
1997,RCD Mallorca,60,7,55,39,16,16,10,12
1997,Real Betis,59,8,49,50,-1,17,13,8
1997,Valencia CF,55,9,58,52,6,16,15,7
1997,Espanyol Barcelona,53,10,44,31,13,12,9,17
1997,Real Valladolid,50,11,36,47,-11,13,14,11
1997,Deportivo La Coruna,49,12,44,46,-2,12,13,13
1997,Real Zaragoza,48,13,45,53,-8,12,14,12
1997,Racing Santander,45,14,46,55,-9,12,17,9
1997,CD Tenerife,45,15,44,57,-13,11,15,12
1997,UD Salamanca,45,16,46,46,0,12,17,9
1997,SD Compostela,44,17,56,66,-10,11,16,11
1997,Real Oviedo,40,18,36,51,-15,9,16,13
1997,CP Merida,39,19,33,53,-20,9,17,12
1997,Sporting Gijon,13,20,31,80,-49,2,29,7
1998,FC Barcelona,79,1,87,43,44,24,7,7
1998,Real Madrid,68,2,77,62,15,21,12,5
1998,RCD Mallorca,66,3,48,31,17,20,12,6
1998,Valencia CF,65,4,63,39,24,19,11,8
1998,Celta Vigo,64,5,69,41,28,17,8,13
1998,Deportivo La Coruna,63,6,55,43,12,17,9,12
1998,Espanyol Barcelona,61,7,49,38,11,16,9,13
1998,Athletic Bilbao,60,8,53,47,6,17,12,9
1998,Real Zaragoza,57,9,57,46,11,16,13,9
1998,Real Sociedad,54,10,47,43,4,14,12,12
1998,Real Betis,49,11,47,58,-11,14,17,7
1998,Real Valladolid,48,12,35,44,-9,13,16,9
1998,Atletico Madrid,46,13,54,50,4,12,16,10
1998,Real Oviedo,45,14,41,57,-16,11,15,12
1998,Racing Santander,42,15,41,53,-12,10,16,12
1998,CD Alaves,40,16,36,63,-27,11,20,7
1998,CF Extremadura,39,17,27,53,-26,9,17,12
1998,Villarreal CF,36,18,47,63,-16,8,18,12
1998,CD Tenerife,34,19,41,63,-22,7,18,13
1998,UD Salamanca,27,20,29,66,-37,7,25,6
1999,Deportivo La Coruna,69,1,66,44,22,21,11,6
1999,Valencia CF,64,2,59,39,20,18,10,10
1999,FC Barcelona,64,3,70,46,24,19,12,7
1999,Real Zaragoza,63,4,60,40,20,16,7,15
1999,Real Madrid,62,5,58,48,10,16,8,14
1999,CD Alaves,61,6,41,37,4,17,11,10
1999,Celta Vigo,53,7,45,43,2,15,15,8
1999,Real Valladolid,53,8,36,44,-8,14,13,11
1999,Rayo Vallecano,52,9,51,53,-2,15,16,7
1999,RCD Mallorca,51,10,52,45,7,14,15,9
1999,Athletic Bilbao,50,11,47,57,-10,12,12,14
1999,Malaga CF,48,12,55,50,5,11,12,15
1999,Espanyol Barcelona,47,13,51,48,3,12,15,11
1999,Real Sociedad,47,14,42,49,-7,11,13,14
1999,Racing Santander,46,15,52,50,2,10,12,16
1999,Real Oviedo,45,16,44,60,-16,11,15,12
1999,CD Numancia,45,17,47,59,-12,11,15,12
1999,Real Betis,42,18,33,56,-23,11,18,9
1999,Atletico Madrid,38,19,48,64,-16,9,18,11
1999,Sevilla FC,28,20,42,67,-25,5,20,13
2000,Real Madrid,80,1,81,40,41,24,6,8
2000,Deportivo La Coruna,73,2,73,44,29,22,9,7
2000,RCD Mallorca,71,3,61,43,18,20,7,11
2000,FC Barcelona,63,4,80,57,23,17,9,12
2000,Valencia CF,63,5,55,34,21,18,11,9
2000,Celta Vigo,59,6,51,49,2,16,11,11
2000,Villarreal CF,57,7,58,52,6,16,13,9
2000,Malaga CF,56,8,60,61,-1,16,14,8
2000,Espanyol Barcelona,50,9,46,44,2,14,16,8
2000,CD Alaves,49,10,58,59,-1,14,17,7
2000,UD Las Palmas,46,11,42,62,-20,13,18,7
2000,Real Sociedad,43,12,52,68,-16,11,17,10
2000,Athletic Bilbao,43,13,44,60,-16,11,17,10
2000,Rayo Vallecano,43,14,56,68,-12,10,15,13
2000,CA Osasuna,42,15,43,54,-11,10,16,12
2000,Real Valladolid,42,16,42,50,-8,9,14,15
2000,Real Zaragoza,42,17,54,57,-3,9,14,15
2000,Real Oviedo,41,18,51,67,-16,11,19,8
2000,CD Numancia,39,19,40,64,-24,10,19,9
2000,Racing Santander,39,20,48,62,-14,10,19,9
2001,Valencia CF,75,1,51,27,24,21,5,12
2001,Deportivo La Coruna,68,2,65,41,24,20,10,8
2001,Real Madrid,66,3,69,44,25,19,10,9
2001,FC Barcelona,64,4,65,37,28,18,10,10
2001,Celta Vigo,60,5,64,46,18,16,10,12
2001,Real Betis,59,6,42,34,8,15,9,14
2001,CD Alaves,54,7,41,44,-3,17,18,3
2001,Athletic Bilbao,53,8,54,66,-12,14,13,11
2001,Malaga CF,53,9,44,44,0,13,11,14
2001,Sevilla FC,53,10,51,40,11,14,13,11
2001,Rayo Vallecano,49,11,46,52,-6,13,15,10
2001,Real Valladolid,48,12,45,58,-13,13,16,9
2001,Espanyol Barcelona,47,13,47,56,-9,13,17,8
2001,Real Sociedad,47,14,48,54,-6,13,17,8
2001,RCD Mallorca,43,15,40,52,-12,11,17,10
2001,Villarreal CF,43,16,46,55,-9,11,17,10
2001,CA Osasuna,42,17,36,49,-13,10,16,12
2001,UD Las Palmas,40,18,40,50,-10,9,16,13
2001,CD Tenerife,38,19,32,58,-26,10,20,8
2001,Real Zaragoza,37,20,35,54,-19,9,19,10
2002,Real Madrid,78,1,86,42,44,22,4,12
2002,Real Sociedad,76,2,71,45,26,22,6,10
2002,Deportivo La Coruna,72,3,67,47,20,22,10,6
2002,Celta Vigo,61,4,45,36,9,17,11,10
2002,Valencia CF,60,5,56,35,21,17,12,9
2002,FC Barcelona,56,6,63,47,16,15,12,11
2002,Athletic Bilbao,55,7,63,61,2,15,13,10
2002,Real Betis,54,8,56,53,3,14,12,12
2002,RCD Mallorca,52,9,49,56,-7,14,14,10
2002,Sevilla FC,50,10,38,39,-1,13,14,11
2002,Atletico Madrid,47,11,51,56,-5,12,15,11
2002,CA Osasuna,47,12,40,48,-8,12,15,11
2002,Real Valladolid,46,13,37,40,-3,12,16,10
2002,Malaga CF,46,14,44,49,-5,11,14,13
2002,Villarreal CF,45,15,44,53,-9,11,15,12
2002,Racing Santander,44,16,54,64,-10,13,20,5
2002,Espanyol Barcelona,43,17,48,54,-6,10,15,13
2002,Recreativo Huelva,36,18,35,61,-26,8,18,12
2002,CD Alaves,35,19,38,68,-30,8,19,11
2002,Rayo Vallecano,32,20,31,62,-31,7,20,11
2003,Valencia CF,77,1,71,27,44,23,7,8
2003,FC Barcelona,72,2,63,39,24,21,8,9
2003,Deportivo La Coruna,71,3,60,34,26,21,9,8
2003,Real Madrid,70,4,72,54,18,21,10,7
2003,Athletic Bilbao,56,5,53,49,4,15,12,11
2003,Sevilla FC,55,6,56,45,11,15,13,10
2003,Atletico Madrid,55,7,51,53,-2,15,13,10
2003,Villarreal CF,54,8,47,49,-2,15,14,9
2003,Real Betis,52,9,46,43,3,13,12,13
2003,Malaga CF,51,10,50,55,-5,15,17,6
2003,RCD Mallorca,51,11,54,66,-12,15,17,6
2003,Real Zaragoza,48,12,46,55,-9,13,16,9
2003,CA Osasuna,48,13,38,37,1,11,12,15
2003,Albacete,47,14,40,48,-8,13,17,8
2003,Real Sociedad,46,15,49,53,-4,11,14,13
2003,Racing Santander,43,16,48,63,-15,11,17,10
2003,Espanyol Barcelona,43,17,48,64,-16,13,21,4
2003,Real Valladolid,41,18,46,56,-10,10,17,11
2003,Celta Vigo,39,19,48,68,-20,9,17,12
2003,Real Murcia,26,20,29,57,-28,5,22,11
2004,FC Barcelona,84,1,73,29,44,25,4,9
2004,Real Madrid,80,2,71,32,39,25,8,5
2004,Villarreal CF,65,3,69,37,32,18,9,11
2004,Real Betis,62,4,62,50,12,16,8,14
2004,Espanyol Barcelona,61,5,54,46,8,17,11,10
2004,Sevilla FC,60,6,44,41,3,17,12,9
2004,Valencia CF,58,7,54,39,15,14,8,16
2004,Malaga CF,51,8,40,48,-8,15,17,6
2004,Athletic Bilbao,51,9,59,54,5,14,15,9
2004,Deportivo La Coruna,51,10,46,50,-4,12,11,15
2004,Atletico Madrid,50,11,40,34,6,13,14,11
2004,Real Zaragoza,50,12,52,57,-5,14,16,8
2004,Real Sociedad,47,13,47,56,-9,13,17,8
2004,Getafe CF,47,14,38,46,-8,12,15,11
2004,CA Osasuna,46,15,47,65,-18,12,16,10
2004,Racing Santander,44,16,41,58,-17,12,18,8
2004,RCD Mallorca,39,17,42,63,-21,10,19,9
2004,Levante UD,37,18,39,58,-19,9,19,10
2004,CD Numancia,29,19,30,61,-31,6,21,11
2004,Albacete,28,20,33,57,-24,6,22,10
2005,FC Barcelona,82,1,80,35,45,25,6,7
2005,Real Madrid,70,2,70,40,30,20,8,10
2005,Valencia CF,69,3,58,33,25,19,7,12
2005,Sevilla FC,68,4,54,39,15,20,10,8
2005,CA Osasuna,68,5,49,43,6,21,12,5
2005,Celta Vigo,64,6,45,33,12,20,14,4
2005,Villarreal CF,57,7,50,39,11,14,9,15
2005,Deportivo La Coruna,55,8,47,45,2,15,13,10
2005,Getafe CF,54,9,54,49,5,15,14,9
2005,Atletico Madrid,52,10,45,37,8,13,12,13
2005,Real Zaragoza,46,11,46,51,-5,10,12,16
2005,Athletic Bilbao,45,12,40,46,-6,11,15,12
2005,RCD Mallorca,43,13,37,51,-14,10,15,13
2005,Real Betis,42,14,34,51,-17,10,16,12
2005,Espanyol Barcelona,41,15,36,56,-20,10,17,11
2005,Real Sociedad,40,16,48,65,-17,11,20,7
2005,Racing Santander,40,17,36,49,-13,9,16,13
2005,CD Alaves,39,18,35,54,-19,9,17,12
2005,Cadiz CF,36,19,36,52,-16,8,18,12
2005,Malaga CF,24,20,36,68,-32,5,24,9
2006,FC Barcelona,76,1,78,33,45,22,6,10
2006,Real Madrid,76,2,66,40,26,23,8,7
2006,Sevilla FC,71,3,64,35,29,21,9,8
2006,Valencia CF,66,4,57,42,15,20,12,6
2006,Villarreal CF,62,5,48,44,4,18,12,8
2006,Atletico Madrid,60,6,46,39,7,17,12,9
2006,Real Zaragoza,60,7,55,43,12,16,10,12
2006,Recreativo Huelva,54,8,54,52,2,15,14,9
2006,Getafe CF,52,9,39,33,6,14,14,10
2006,Racing Santander,50,10,42,48,-6,12,12,14
2006,Espanyol Barcelona,49,11,46,53,-7,12,13,13
2006,RCD Mallorca,49,12,41,47,-6,14,17,7
2006,Deportivo La Coruna,47,13,32,45,-13,12,15,11
2006,CA Osasuna,46,14,51,49,2,13,18,7
2006,Levante UD,42,15,37,53,-16,10,16,12
2006,Athletic Bilbao,40,16,44,62,-18,10,18,10
2006,Real Betis,40,17,36,49,-13,8,14,16
2006,Celta Vigo,39,18,40,59,-19,10,19,9
2006,Real Sociedad,35,19,32,47,-15,8,19,11
2006,Gimnastic,28,20,34,69,-35,7,24,7
2007,Real Madrid,85,1,84,36,48,27,7,4
2007,Villarreal CF,77,2,63,40,23,24,9,5
2007,FC Barcelona,67,3,76,43,33,19,9,10
2007,Sevilla FC,64,4,75,49,26,20,14,4
2007,Atletico Madrid,64,5,66,47,19,19,12,7
2007,Racing Santander,60,6,42,41,1,17,12,9
2007,RCD Mallorca,59,7,69,54,15,15,9,14
2007,Deportivo La Coruna,52,8,46,47,-1,15,16,7
2007,UD Almeria,52,9,42,45,-3,14,14,10
2007,Valencia CF,51,10,48,62,-14,15,17,6
2007,Athletic Bilbao,50,11,40,43,-3,13,14,11
2007,Espanyol Barcelona,48,12,43,53,-10,13,16,9
2007,Real Betis,47,13,45,51,-6,12,15,11
2007,Getafe CF,47,14,44,48,-4,12,15,11
2007,Real Valladolid,45,15,42,57,-15,11,15,12
2007,Recreativo Huelva,44,16,40,60,-20,11,16,11
2007,CA Osasuna,43,17,37,44,-7,12,19,7
2007,Real Zaragoza,42,18,50,61,-11,10,16,12
2007,Real Murcia,30,19,36,65,-29,7,22,9
2007,Levante UD,26,20,33,75,-42,7,26,5
2008,FC Barcelona,87,1,105,35,70,27,5,6
2008,Real Madrid,78,2,83,52,31,25,10,3
2008,Sevilla FC,70,3,54,39,15,21,10,7
2008,Atletico Madrid,67,4,80,57,23,20,11,7
2008,Villarreal CF,65,5,61,54,7,18,9,11
2008,Valencia CF,62,6,68,54,14,18,12,8
2008,Deportivo La Coruna,58,7,48,47,1,16,12,10
2008,Malaga CF,55,8,55,59,-4,15,13,10
2008,RCD Mallorca,51,9,53,60,-7,14,15,9
2008,Espanyol Barcelona,47,10,46,49,-3,12,15,11
2008,Racing Santander,46,11,49,48,1,12,16,10
2008,UD Almeria,46,12,45,61,-16,13,18,7
2008,Athletic Bilbao,44,13,47,62,-15,12,18,8
2008,CA Osasuna,43,14,41,47,-6,10,15,13
2008,Real Valladolid,43,15,46,58,-12,12,19,7
2008,Sporting Gijon,43,16,47,79,-32,14,23,1
2008,Real Betis,42,17,51,58,-7,10,16,12
2008,Getafe CF,42,18,50,56,-6,10,16,12
2008,CD Numancia,35,19,38,69,-31,10,23,5
2008,Recreativo Huelva,33,20,34,57,-23,8,21,9
2009,FC Barcelona,99,1,98,24,74,31,1,6
2009,Real Madrid,96,2,102,35,67,31,4,3
2009,Valencia CF,71,3,59,40,19,21,9,8
2009,Sevilla FC,63,4,65,49,16,19,13,6
2009,RCD Mallorca,62,5,59,44,15,18,12,8
2009,Getafe CF,58,6,58,48,10,17,14,7
2009,Villarreal CF,56,7,58,57,1,16,14,8
2009,Athletic Bilbao,54,8,50,53,-3,15,14,9
2009,Atletico Madrid,47,9,57,61,-4,13,17,8
2009,Deportivo La Coruna,47,10,35,49,-14,13,17,8
2009,Espanyol Barcelona,44,11,29,46,-17,11,16,11
2009,CA Osasuna,43,12,37,46,-9,11,17,10
2009,UD Almeria,42,13,43,55,-12,10,16,12
2009,Real Zaragoza,41,14,46,64,-18,10,17,11
2009,Sporting Gijon,40,15,36,51,-15,9,16,13
2009,Racing Santander,39,16,42,59,-17,9,17,12
2009,Malaga CF,37,17,42,48,-6,7,15,16
2009,Real Valladolid,36,18,37,62,-25,7,16,15
2009,CD Tenerife,36,19,40,74,-34,9,20,9
2009,Xerez CD,34,20,38,66,-28,8,20,10
2010,FC Barcelona,96,1,95,21,74,30,2,6
2010,Real Madrid,92,2,102,33,69,29,4,5
2010,Valencia CF,71,3,64,44,20,21,9,8
2010,Villarreal CF,62,4,54,44,10,18,12,8
2010,Sevilla FC,58,5,62,61,1,17,14,7
2010,Athletic Bilbao,58,6,59,55,4,18,16,4
2010,Atletico Madrid,58,7,62,53,9,17,14,7
2010,Espanyol Barcelona,49,8,46,55,-9,15,19,4
2010,CA Osasuna,47,9,45,46,-1,13,17,8
2010,Sporting Gijon,47,10,35,42,-7,11,13,14
2010,Malaga CF,46,11,54,68,-14,13,18,7
2010,Racing Santander,46,12,41,56,-15,12,16,10
2010,Real Sociedad,45,13,49,66,-17,14,21,3
2010,Levante UD,45,14,41,52,-11,12,17,9
2010,Real Zaragoza,45,15,40,53,-13,12,17,9
2010,RCD Mallorca,44,16,41,56,-15,12,18,8
2010,Getafe CF,44,17,49,60,-11,12,18,8
2010,Deportivo La Coruna,43,18,31,47,-16,10,15,13
2010,Hercules CF,35,19,36,60,-24,9,21,8
2010,UD Almeria,30,20,36,70,-34,6,20,12
2011,Real Madrid,100,1,121,32,89,32,2,4
2011,FC Barcelona,91,2,114,29,85,28,3,7
2011,Valencia CF,61,3,59,44,15,17,11,10
2011,Malaga CF,58,4,54,53,1,17,14,7
2011,Atletico Madrid,56,5,53,46,7,15,12,11
2011,Levante UD,55,6,54,50,4,16,15,7
2011,CA Osasuna,54,7,44,61,-17,13,10,15
2011,RCD Mallorca,52,8,42,46,-4,14,14,10
2011,Sevilla FC,50,9,48,47,1,13,14,11
2011,Athletic Bilbao,49,10,49,52,-3,12,13,13
2011,Real Betis,47,11,47,56,-9,13,17,8
2011,Real Sociedad,47,12,46,52,-6,12,15,11
2011,Getafe CF,47,13,40,51,-11,12,15,11
2011,Espanyol Barcelona,46,14,46,56,-10,12,16,10
2011,Rayo Vallecano,43,15,53,73,-20,13,21,4
2011,Real Zaragoza,43,16,36,61,-25,12,19,7
2011,Granada CF,42,17,35,56,-21,12,20,6
2011,Villarreal CF,41,18,39,53,-14,9,15,14
2011,Sporting Gijon,37,19,42,69,-27,10,21,7
2011,Racing Santander,27,20,28,63,-35,4,19,15
2012,FC Barcelona,100,1,115,40,75,32,2,4
2012,Real Madrid,85,2,103,42,61,26,5,7
2012,Atletico Madrid,76,3,65,31,34,23,8,7
2012,Real Sociedad,66,4,70,49,21,18,8,12
2012,Valencia CF,65,5,67,54,13,19,11,8
2012,Malaga CF,57,6,53,50,3,16,13,9
2012,Real Betis,56,7,57,56,1,16,14,8
2012,Rayo Vallecano,53,8,50,66,-16,16,17,5
2012,Sevilla FC,50,9,58,54,4,14,16,8
2012,Getafe CF,47,10,43,57,-14,13,17,8
2012,Levante UD,46,11,40,57,-17,12,16,10
2012,Athletic Bilbao,45,12,44,65,-21,12,17,9
2012,Espanyol Barcelona,44,13,43,52,-9,11,16,11
2012,Real Valladolid,43,14,49,58,-9,11,17,10
2012,Granada CF,42,15,37,54,-17,11,18,9
2012,CA Osasuna,39,16,33,50,-17,10,19,9
2012,Celta Vigo,37,17,37,52,-15,10,21,7
2012,RCD Mallorca,36,18,43,72,-29,9,20,9
2012,Deportivo La Coruna,35,19,47,70,-23,8,19,11
2012,Real Zaragoza,34,20,37,62,-25,9,22,7
2013,Atletico Madrid,90,1,77,26,51,28,4,6
2013,FC Barcelona,87,2,100,33,67,27,5,6
2013,Real Madrid,87,3,104,38,66,27,5,6
2013,Athletic Bilbao,70,4,66,39,27,20,8,10
2013,Sevilla FC,63,5,69,52,17,18,11,9
2013,Villarreal CF,59,6,60,44,16,17,13,8
2013,Real Sociedad,59,7,62,55,7,16,11,11
2013,Celta Vigo,49,8,49,54,-5,14,17,7
2013,Valencia CF,49,9,51,53,-2,13,15,10
2013,Levante UD,48,10,35,43,-8,12,14,12
2013,Malaga CF,45,11,39,46,-7,12,17,9
2013,Rayo Vallecano,43,12,46,80,-34,13,21,4
2013,Getafe CF,42,13,35,54,-19,11,18,9
2013,Espanyol Barcelona,42,14,41,51,-10,11,18,9
2013,Granada CF,41,15,32,56,-24,12,21,5
2013,UD Almeria,40,16,43,71,-28,11,20,7
2013,Elche CF,40,17,30,50,-20,9,16,13
2013,CA Osasuna,39,18,32,62,-30,10,19,9
2013,Real Valladolid,36,19,38,60,-22,7,16,15
2013,Real Betis,25,20,36,78,-42,6,25,7
2014,FC Barcelona,94,1,110,21,89,30,4,4
2014,Real Madrid,92,2,118,38,80,30,6,2
2014,Atletico Madrid,78,3,67,29,38,23,6,9
2014,Valencia CF,77,4,70,32,38,22,5,11
2014,Sevilla FC,76,5,71,45,26,23,8,7
2014,Villarreal CF,60,6,48,37,11,16,10,12
2014,Athletic Bilbao,55,7,42,41,1,15,13,10
2014,Celta Vigo,51,8,47,44,3,13,13,12
2014,Malaga CF,50,9,42,48,-6,14,16,8
2014,Rayo Vallecano,49,10,46,68,-22,15,19,4
2014,Espanyol Barcelona,49,11,47,51,-4,13,15,10
2014,Real Sociedad,46,12,44,51,-7,11,14,13
2014,Elche CF,41,13,35,62,-27,11,19,8
2014,Levante UD,37,14,34,67,-33,9,19,10
2014,Getafe CF,37,15,33,64,-31,10,21,7
2014,SD Eibar,35,16,34,55,-21,9,21,8
2014,Granada CF,35,17,29,64,-35,7,17,14
2014,Deportivo La Coruna,35,18,35,60,-25,7,17,14
2014,UD Almeria,32,19,35,64,-29,8,22,8
2014,Cordoba CF,20,20,22,68,-46,3,24,11
2015,FC Barcelona,91,1,112,29,83,29,5,4
2015,Real Madrid,90,2,110,34,76,28,4,6
2015,Atletico Madrid,88,3,63,18,45,28,6,4
2015,Villarreal CF,64,4,44,35,9,18,10,10
2015,Athletic Bilbao,62,5,58,45,13,18,12,8
2015,Celta Vigo,60,6,51,59,-8,17,12,9
2015,Sevilla FC,52,7,51,50,1,14,14,10
2015,Real Sociedad,48,8,45,48,-3,13,16,9
2015,Malaga CF,48,9,38,35,3,12,14,12
2015,Real Betis,45,10,34,52,-18,11,15,12
2015,Valencia CF,44,11,46,48,-2,11,16,11
2015,UD Las Palmas,44,12,45,53,-8,12,18,8
2015,Espanyol Barcelona,43,13,40,74,-34,12,19,7
2015,SD Eibar,43,14,49,61,-12,11,17,10
2015,Deportivo La Coruna,42,15,45,61,-16,8,12,18
2015,Sporting Gijon,39,16,40,62,-22,10,19,9
2015,Granada CF,39,17,46,69,-23,10,19,9
2015,Rayo Vallecano,38,18,52,73,-21,9,18,11
2015,Getafe CF,36,19,37,67,-30,9,20,9
2015,Levante UD,32,20,37,70,-33,8,22,8
2016,Real Madrid,93,1,106,41,65,29,3,6
2016,FC Barcelona,90,2,116,37,79,28,4,6
2016,Atletico Madrid,78,3,70,27,43,23,6,9
2016,Sevilla FC,72,4,69,49,20,21,8,9
2016,Villarreal CF,67,5,56,33,23,19,9,10
2016,Real Sociedad,64,6,59,53,6,19,12,7
2016,Athletic Bilbao,63,7,53,43,10,19,13,6
2016,Espanyol Barcelona,56,8,49,50,-1,15,12,11
2016,CD Alaves,55,9,41,43,-2,14,11,13
2016,SD Eibar,54,10,56,51,5,15,14,9
2016,Valencia CF,46,11,56,65,-9,13,18,7
2016,Malaga CF,46,12,49,55,-6,12,16,10
2016,Celta Vigo,45,13,53,69,-16,13,19,6
2016,Real Betis,39,14,41,64,-23,10,19,9
2016,UD Las Palmas,39,15,53,74,-21,10,19,9
2016,Deportivo La Coruna,36,16,43,61,-18,8,18,12
2016,CD Leganes,35,17,36,55,-19,8,19,11
2016,Sporting Gijon,31,18,42,72,-30,7,21,10
2016,CA Osasuna,22,19,40,94,-54,4,24,10
2016,Granada CF,20,20,30,82,-52,4,26,8
2017,FC Barcelona,93,1,99,29,70,28,1,9
2017,Atletico Madrid,79,2,58,22,36,23,5,10
2017,Real Madrid,76,3,94,44,50,22,6,10
2017,Valencia CF,73,4,65,38,27,22,9,7
2017,Villarreal CF,61,5,57,50,7,18,13,7
2017,Real Betis,60,6,60,61,-1,18,14,6
2017,Sevilla FC,58,7,49,58,-9,17,14,7
2017,Getafe CF,55,8,42,33,9,15,13,10
2017,Girona,51,9,50,59,-9,14,15,9
2017,SD Eibar,51,10,44,50,-6,14,15,9
2017,Celta Vigo,49,11,59,60,-1,13,15,10
2017,Real Sociedad,49,12,66,59,7,14,17,7
2017,Espanyol Barcelona,49,13,36,42,-6,12,13,13
2017,CD Alaves,47,14,40,50,-10,15,21,2
2017,Levante UD,46,15,44,58,-14,11,14,13
2017,Athletic Bilbao,43,16,41,49,-8,10,15,13
2017,CD Leganes,43,17,34,51,-17,12,19,7
2017,Deportivo La Coruna,29,18,38,76,-38,6,21,11
2017,UD Las Palmas,22,19,24,74,-50,5,26,7
2017,Malaga CF,20,20,24,61,-37,5,28,5
2018,FC Barcelona,87,1,90,36,54,26,3,9
2018,Atletico Madrid,76,2,55,29,26,22,6,10
2018,Real Madrid,68,3,63,46,17,21,12,5
2018,Valencia CF,61,4,51,35,16,15,7,16
2018,Getafe CF,59,5,48,35,13,15,9,14
2018,Sevilla FC,59,6,62,47,15,17,13,8
2018,Espanyol Barcelona,53,7,48,50,-2,14,13,11
2018,Athletic Bilbao,53,8,41,45,-4,13,11,14
2018,Real Betis,50,9,44,52,-8,14,16,8
2018,CD Alaves,50,10,39,50,-11,13,14,11
2018,Real Sociedad,50,11,45,46,-1,13,14,11
2018,SD Eibar,47,12,46,50,-4,11,13,14
2018,CD Leganes,45,13,37,43,-6,11,15,12
2018,Villarreal CF,44,14,49,52,-3,10,14,14
2018,Levante UD,44,15,59,66,-7,11,16,11
2018,Real Valladolid,41,16,32,51,-19,10,17,11
2018,Celta Vigo,41,17,53,62,-9,10,17,11
2018,Girona,37,18,37,53,-16,9,19,10
2018,SD Huesca,33,19,43,65,-22,7,19,12
2018,Rayo Vallecano,32,20,41,70,-29,8,22,8
2019,Real Madrid,87,1,70,25,45,26,3,9
2019,FC Barcelona,82,2,86,38,48,25,6,7
2019,Sevilla FC,70,3,54,34,20,19,6,13
2019,Atletico Madrid,70,4,51,27,24,18,4,16
2019,Villarreal CF,60,5,63,49,14,18,14,6
2019,Granada CF,56,6,52,45,7,16,14,8
2019,Real Sociedad,56,7,56,48,8,16,14,8
2019,Getafe CF,54,8,43,37,6,14,12,12
2019,Valencia CF,53,9,46,53,-7,14,13,11
2019,CA Osasuna,52,10,46,54,-8,13,12,13
2019,Athletic Bilbao,51,11,41,38,3,13,13,12
2019,Levante UD,49,12,47,53,-6,14,17,7
2019,Real Valladolid,42,13,32,43,-11,9,14,15
2019,SD Eibar,42,14,39,56,-17,11,18,9
2019,Real Betis,41,15,48,60,-12,10,17,11
2019,CD Alaves,39,16,34,59,-25,10,19,9
2019,Celta Vigo,37,17,37,49,-12,7,15,16
2019,CD Leganes,36,18,30,51,-21,8,18,12
2019,RCD Mallorca,33,19,40,65,-25,9,23,6
2019,Espanyol Barcelona,25,20,27,58,-31,5,23,10
2020,Atletico Madrid,86,1,67,25,42,26,4,8
2020,Real Madrid,84,2,67,28,39,25,4,9
2020,FC Barcelona,79,3,85,38,47,24,7,7
2020,Sevilla FC,77,4,53,33,20,24,9,5
2020,Real Sociedad,62,5,59,38,21,17,10,11
2020,Real Betis,61,6,50,50,0,17,11,10
2020,Villarreal CF,58,7,60,44,16,15,10,13
2020,Celta Vigo,53,8,55,57,-2,14,13,11
2020,Athletic Bilbao,46,9,46,42,4,11,14,13
2020,Granada CF,46,10,47,65,-18,13,18,7
2020,CA Osasuna,44,11,37,48,-11,11,16,11
2020,Cadiz CF,44,12,36,58,-22,11,16,11
2020,Valencia CF,43,13,50,53,-3,10,15,13
2020,Levante UD,41,14,46,57,-11,9,15,14
2020,Getafe CF,38,15,28,43,-15,9,18,11
2020,CD Alaves,38,16,36,57,-21,9,18,11
2020,Elche CF,36,17,34,55,-21,8,18,12
2020,SD Huesca,34,18,34,53,-19,7,18,13
2020,Real Valladolid,31,19,34,57,-23,5,17,16
2020,SD Eibar,30,20,29,52,-23,6,20,12
2021,Real Madrid,86,1,80,31,49,26,4,8
2021,FC Barcelona,73,2,68,38,30,21,7,10
2021,Atletico Madrid,71,3,65,43,22,21,9,8
2021,Sevilla FC,70,4,53,30,23,18,4,16
2021,Real Betis,65,5,62,40,22,19,11,8
2021,Real Sociedad,62,6,40,37,3,17,10,11
2021,Villarreal CF,59,7,63,37,26,16,11,11
2021,Athletic Bilbao,55,8,43,36,7,14,11,13
2021,Valencia CF,48,9,48,53,-5,11,12,15
2021,CA Osasuna,47,10,37,51,-14,12,15,11
2021,Celta Vigo,46,11,43,43,0,12,16,10
2021,Elche CF,42,12,40,52,-12,11,18,9
2021,Espanyol Barcelona,42,13,40,53,-13,10,16,12
2021,Rayo Vallecano,42,14,39,50,-11,11,18,9
2021,RCD Mallorca,39,15,36,63,-27,10,19,9
2021,Cadiz CF,39,16,35,51,-16,8,15,15
2021,Getafe CF,39,17,33,41,-8,8,15,15
2021,Granada CF,38,18,44,61,-17,8,16,14
2021,Levante UD,35,19,51,76,-25,8,19,11
2021,CD Alaves,31,20,31,65,-34,8,23,7
